AC 2 Carrier (LB-X).blk	MM
AC-2 Carrier (LB-C3i).blk	MWL
AC2 Carrier Primitive.blk	MM
AC2 Carrier.blk	MM
Achileus (WoB)  [Flamer].blk	MM
Achileus (WoB)  [Laser].blk	MM
Achileus (WoB)  [MG].blk	MM
Achileus (WoB) [David].blk	MM
Achileus (WoB) [TAG].blk	MM
Achileus (WoB) IS.blk	MM
Achileus (WoB).blk	MM
Achileus (WoB-Scout).blk	MWL
Achileus [David].blk	MM
Achileus [Flamer].blk	MM
Achileus [Laser].blk	MM
Achileus [MG].blk	MM
Achileus [TAG].blk	MM
Adder N.mtf	MWL
Adder R.mtf	MWL
Aerie PA(L) (Salvage).blk	MM
Aerie PA(L).blk	MM
Aeron Strike VTOL (BAP).blk	MM
Aeron Strike VTOL.blk	MM
Aesir Medium AA Vehicle (HAG).blk	MM
Aesir Medium AA Vehicle (Standard).blk	MM
Afreet (HH) Elite.blk	MWL
Afreet (Interdictor) Elite.BLK	MWL
Afreet (JF) Elite.blk	MWL
Afreet Elite.blk	MWL
Afreet Medium Battle Armor (HH).blk	MM
Afreet Medium Battle Armor (Interdictor).blk	MM
Afreet Medium Battle Armor (JF).blk	MM
Afreet Medium Battle Armor.blk	MM
Agrotera AGT-1A.mtf	MM
Ahab AHB-443.blk	MWL
Ahab AHB-643.blk	MWL
Ahab AHB-MD.blk	MWL
Ahab AHB-X.blk	MWL
Ailette Rescue PA(L).blk	MM
Ailette Zero-G Engineering Exoskeleton (Standard).blk	MM
Air Car.blk	MM
Aithon Assault Transport.blk	MM
Ajax Assault Tank (Sealed).blk	MM
Ajax Assault Tank A.blk	MM
Ajax Assault Tank B.blk	MM
Ajax Assault Tank C.blk	MM
Ajax Assault Tank D.blk	MM
Ajax Assault Tank Prime.blk	MM
Akuma AKU-1C.mtf	MWL
Akuma AKU-1X.mtf	MM
Akuma AKU-1XJ.mtf	MM
Akuma AKU-2F.mtf	MWL
Akuma AKU-2X.mtf	MM
Akuma AKU-2XC.mtf	MM
Akuma AKU-2XK.mtf	MM
Akuma AKU-3X.mtf	MWL
Akuma AKU-3XJ.mtf	MWL
Alacorn Heavy Tank Mk III.blk	MM
Alacorn Heavy Tank Mk IV.blk	MM
Alacorn Heavy Tank Mk VI.blk	MM
Alacorn Heavy Tank Mk VII.blk	MM
Alacorn Mk I.blk	MM
Alacorn Mk II.blk	MM
Albatross ALB-3Hp.mtf	MWL
Albatross ALB-3U.mtf	MM
Albatross ALB-3Ur.mtf	MM
Albatross ALB-4HG Home Guard.mtf	MWL
Albatross ALB-4U.mtf	MM
Albatross ALB-4W.mtf	MWL
Albatross ALB-5U.mtf	MWL
Albatross ALB-5W Dantalion.mtf	MM
Albatross ALB-8C.mtf	MWL
Alfar AL-A1.mtf	MM
Alfar AL-D1 Dokkalfar.mtf	MM
Amazon BattleArmor MRR.blk	MM
Amazon BattleArmor PPC.blk	MM
Ammon 2.blk	MWL
Anat APC (Standard).blk	MM
Angerona (Standard).blk	MWL
Angerona Scout Suit (Recon).blk	MM
Angerona Scout Suit.blk	MM
Anhur P-Stealth.blk	MM
Anhur Transport (BA).blk	MM
Anhur Transport.blk	MM
Annihilator ANH-1A.mtf	MM
Annihilator ANH-1E.mtf	MM
Annihilator ANH-1G.mtf	MM
Annihilator ANH-1X.mtf	MM
Annihilator ANH-2A.mtf	MM
Annihilator ANH-2AX.mtf	MM
Annihilator ANH-2HG.mtf	MWL
Annihilator ANH-3A.mtf	MM
Annihilator ANH-3HS.mtf	MWL
Annihilator ANH-4A.mtf	MM
Annihilator ANH-5RC.mtf	MWL
Annihilator ANH-9SA.mtf	MWL
Annihilator Bryan Gausszilla.mtf	MM
Annihilator C.mtf	MM
Annihilator C2.mtf	MM
Antlion LK-3D.mtf	MM
Anubis ABS-3C.mtf	MWL
Anubis ABS-3L.mtf	MM
Anubis ABS-3LV.mtf	MWL
Anubis ABS-3MC.mtf	MM
Anubis ABS-3R.mtf	MM
Anubis ABS-3T.mtf	MM
Anubis ABS-4C.mtf	MM
Anubis ABS-5Y.mtf	MM
Anubis ABS-5Z.mtf	MM
Anvil ANV-12M.mtf	MWL
Anvil ANV-3M.mtf	MM
Anvil ANV-3R.mtf	MM
Anvil ANV-5M.mtf	MM
Anvil ANV-5Q.mtf	MM
Anvil ANV-6M.mtf	MM
Anvil ANV-6Q.mtf	MWL
Anvil ANV-8M.mtf	MM
Anvil ANV-9M.mtf	MWL
Anvil ANV-9MER.mtf	MWL
Anzu ZU-G60.mtf	MM
Anzu ZU-J70.mtf	MM
APC (Hover LRM).blk	MM
APC (Hover MG).blk	MM
APC (Hover Sensors).blk	MM
APC (Hover SRM).blk	MM
APC (Hover).blk	MM
APC (Tracked LRM).blk	MM
APC (Tracked MG).blk	MM
APC (Tracked SRM).blk	MM
APC (Tracked).blk	MM
APC (Wheeled LRM).blk	MM
APC (Wheeled MG).blk	MM
APC (Wheeled SRM).blk	MM
APC (Wheeled).blk	MM
Apollo APL-1M.mtf	MM
Apollo APL-1R.mtf	MM
Apollo APL-2Me.mtf	MWL
Apollo APL-2S.mtf	MM
Apollo APL-3M.mtf	MWL
Apollo APL-3T.mtf	MM
Apollo APL-4M.mtf	MM
Apollo APL-4W.mtf	MWL
Aquagladius AQS-3.mtf	MM
Aquagladius AQS-4.mtf	MM
Arana MilitiaMech ARA-S-1.mtf	MM
Arbalest .mtf	MM
Arbalest 2.mtf	MM
Arbalest 3.mtf	MM
Arbiter ARB-001.mtf	MM
Arcas 2.mtf	MM
Arcas 2A.mtf	MWL
Arcas 3.mtf	MM
Arcas.mtf	MM
Archangel C-ANG-O Berith.mtf	MM
Archangel C-ANG-O Comminus.mtf*	MWL
Archangel C-ANG-O Dominus.mtf*	MWL
Archangel C-ANG-O Eminus.mtf*	MWL
Archangel C-ANG-O Infernus II.mtf	MWL
Archangel C-ANG-O Infernus.mtf*	MWL
Archangel C-ANG-O Invictus II.mtf	MWL
Archangel C-ANG-O Invictus.mtf	MM
Archangel C-ANG-O Luminos.mtf*	MWL
Archangel C-ANG-O Zuriel.mtf	MWL
Archangel C-ANG-OA Dominus.mtf	MM
Archangel C-ANG-OB Infernus.mtf	MM
Archangel C-ANG-OC Comminus.mtf	MM
Archangel C-ANG-OD Luminos.mtf	MM
Archangel C-ANG-OE Eminus.mtf	MM
Archangel C-ANG-OS Caelestis.mtf	MM
Archer ARC-2K.mtf	MM
Archer ARC-2R.mtf	MM
Archer ARC-2Rb.mtf	MM
Archer ARC-2RK.mtf	MWL
Archer ARC-2S.mtf	MM
Archer ARC-2TDF.mtf	MWL
Archer ARC-2W.mtf	MM
Archer ARC-4K.mtf	MWL
Archer ARC-4M.mtf	MM
Archer ARC-4RK.mtf	MWL
Archer ARC-5R.mtf	MM
Archer ARC-5RK.mtf	MWL
Archer ARC-5S.mtf	MM
Archer ARC-5W.mtf	MM
Archer ARC-6E.mtf	MWL
Archer ARC-6K.mtf	MWL
Archer ARC-6S.mtf	MM
Archer ARC-6Sr.mtf	MWL
Archer ARC-6SS.mtf	MWL
Archer ARC-6W.mtf	MM
Archer ARC-7C.mtf	MWL
Archer ARC-7L.mtf	MM
Archer ARC-7S.mtf	MM
Archer ARC-8M.mtf	MM
Archer ARC-8MS.mtf	MWL
Archer ARC-9K.mtf	MM
Archer ARC-9KC.mtf	MM
Archer ARC-9M.mtf	MM
Archer ARC-9W.mtf	MM
Archer ARC-EWB Skobal.mtf	MWL
Archer ARC-GBD.mtf	MWL
Archer C.mtf	MM
Archer IIC2.mtf	MWL
Archer IIC-S.mtf	MWL
Archer Wolf.mtf	MM
Arctic Fox AF1.mtf	MM
Arctic Fox AF1A.mtf	MM
Arctic Fox AF1B.mtf	MM
Arctic Fox AF1C.mtf	MM
Arctic Fox AF1D.mtf	MM
Arctic Fox AF1E.mtf	MM
Arctic Fox AF1F.mtf	MM
Arctic Fox AF1P.mtf	MWL
Arctic Fox AF1U.mtf	MM
Arctic Wolf .mtf	MM
Arctic Wolf 2.mtf	MM
Arctic Wolf A.mtf	MM
Arctic Wolf II A.mtf	MM
Arctic Wolf II B.mtf	MM
Arctic Wolf II C.mtf	MM
Arctic Wolf II Prime.mtf	MM
Arctic Wolf J.mtf	MM
Arctic Wolf Prime.mtf	MM
Ares ARS-V1 Aphrodite.mtf	MM
Ares ARS-V1 Hades.mtf	MM
Ares ARS-V1 Hephaestus.mtf	MM
Ares ARS-V1 Hera.mtf	MM
Ares ARS-V1 Zeus.mtf	MM
Ares Medium Tank (Plasma).blk	MM
Ares Medium Tank.blk	MM
Argus AGS-2D.mtf	MM
Argus AGS-3DM.mtf	MWL
Argus AGS-3X.mtf	MWL
Argus AGS-4AC.mtf	MWL
Argus AGS-4D.mtf	MM
Argus AGS-5D.mtf	MM
Argus AGS-5E.mtf	MWL
Argus AGS-6F.mtf	MM
Argus AGS-8DX.mtf	MM
Armored Personnel Carrier (Hover Primitive).blk	MM
Armored Personnel Carrier (Tracked Primitive).blk	MM
Armored Personnel Carrier (Wheeled Primitive).blk	MM
Arrow IV Assault Vehicle (Standard).blk	MM
Artemis ART-1S.mtf	MWL
Assassin Alice.mtf	MM
Assassin ASN-101.mtf	MM
Assassin ASN-21.mtf	MM
Assassin ASN-22.mtf	MWL
Assassin ASN-23.mtf	MM
Assassin ASN-30.mtf	MM
Assassin ASN-99.mtf	MM
Assassin Servitor.mtf	MM
Asshur Artillery Spotter.blk	MM
Asshur Fast Reconnaissance Vehicle (PAC).blk	MM
Asshur Fast Reconnaissance Vehicle.blk	MM
Asterion Medium Battle Armor (Upgrade) [MRR].blk	MM
Asterion Medium Battle Armor (Upgrade) [PPC].blk	MM
Asterion Medium Battle Armor [MRR].blk	MM
Asterion Medium Battle Armor [PPC].blk	MM
Asura Medium Battle Armor (Anti Infantry).blk	MM
Asura Medium Battle Armor (SRM).blk	MM
Asura Medium Battle Armor.blk	MM
Athena Combat Vehicle (HAG).blk	MM
Athena Combat Vehicle.blk	MM
Athena XR.blk	MM
Atlas AS-700 Jurn.mtf	MM
Atlas AS7-6V.mtf	MWL
Atlas AS7-C.mtf	MM
Atlas AS7-CM.mtf	MM
Atlas AS7-D (Danielle).mtf	MM
Atlas AS7-D(C).mtf	MM
Atlas AS7-D.mtf	MM
Atlas AS7-D7.mtf	MWL
Atlas AS7-D-DC.mtf	MM
Atlas AS7-Dr.mtf	MM
Atlas AS7-K.mtf	MM
Atlas AS7-K2 (Jedra).mtf	MM
Atlas AS7-K2.mtf	MM
Atlas AS7-K3.mtf	MM
Atlas AS7-K4.mtf	MM
Atlas AS7-K-DC.mtf	MM
Atlas AS7-R.mtf	MWL
Atlas AS7-RS.mtf	MM
Atlas AS7-S.mtf	MM
Atlas AS7-S2.mtf	MM
Atlas AS7-S3.mtf	MM
Atlas AS7-S5.mtf	MWL
Atlas AS7-W.mtf	MWL
Atlas AS7-WGS Samsonov.mtf	MM
Atlas AS7-X.mtf	MWL
Atlas AS8-D.mtf	MM
Atlas AS9-K.mtf	MWL
Atlas AS9-KX.mtf	MWL
Atlas C.mtf	MM
Atlas II AS7-D-H.mtf	MM
Atlas II AS7-D-H2.mtf	MM
Atlas IIC.mtf	MWL
Atlas III AS7-D2.mtf	MM
Atlas III AS7-D3.mtf	MM
Augustus A3 MBT.blk	MM
Auroch (L5).blk	MWL
Auroch.blk	MWL
Aurora G.blk	MWL
Aurora.blk	MWL
Avalanche AVL-1O.mtf	MM
Avalanche AVL-1OA.mtf	MM
Avalanche AVL-1OB.mtf	MM
Avalanche AVL-1OC.mtf	MM
Avalanche AVL-1ON.mtf	MM
Avalanche AVL-1OR.mtf	MM
Avar A.blk	MWL
Avar B.blk	MWL
Avar C.blk	MWL
Avar D.blk	MWL
Avar J.blk	MWL
Avar Prime.blk	MWL
Avatar AV1-O.mtf	MM
Avatar AV1-OA.mtf	MM
Avatar AV1-OB.mtf	MM
Avatar AV1-OC.mtf	MM
Avatar AV1-OD.mtf	MM
Avatar AV1-OE.mtf	MM
Avatar AV1-OF.mtf	MM
Avatar AV1-OG.mtf	MM
Avatar AV1-OH.mtf	MM
Avatar AV1-OI.mtf	MM
Avatar AV1-OJ.mtf	MM
Avatar AV1-OK.mtf	MWL
Avatar AV1-OR.mtf	MM
Avatar AV1-OS.mtf	MWL
Avatar AV1-OU.mtf	MM
Avatar AV1-OV.mtf	MWL
Awesome AWS-10KM.mtf	MM
Awesome AWS-10MC.mtf	MWL
Awesome AWS-10ME.mtf	MWL
Awesome AWS-11M.mtf	MM
Awesome AWS-13W.mtf	MWL
Awesome AWS-15M.mtf	MWL
Awesome AWS-8Q.mtf	MM
Awesome AWS-8R.mtf	MM
Awesome AWS-8T.mtf	MM
Awesome AWS-8V.mtf	MM
Awesome AWS-9K.mtf	MWL
Awesome AWS-9M.mtf	MM
Awesome AWS-9Ma.mtf	MM
Awesome AWS-9MC.mtf	MWL
Awesome AWS-9ME.mtf	MWL
Awesome AWS-9Q (Klatt).mtf	MM
Awesome AWS-9Q.mtf	MM
Axel Heavy Tank IIC (XL).blk	MM
Axel Heavy Tank Mk 1.blk	MM
Axel Heavy Tank Mk 2.blk	MM
Axel IIC Tank.blk	MM
Axel Mk 3.blk	MWL
Axel Mk 4.blk	MWL
Axman AXM-1N.mtf	MM
Axman AXM-2D.mtf	MWL
Axman AXM-2N.mtf	MM
Axman AXM-3RK.mtf	MWL
Axman AXM-3S.mtf	MM
Axman AXM-3Sr.mtf	MM
Axman AXM-4D.mtf	MM
Axman AXM-5R.mtf	MWL
Axman AXM-6T.mtf	MM
Axman AXM-6X.mtf	MM
Axman AXN-1NA.mtf	MWL
Baboon (Howler) 2.mtf	MM
Baboon (Howler) 3.mtf	MM
Baboon (Howler).mtf	MM
Badger (C) Tracked Transport A.blk	MM
Badger (C) Tracked Transport B.blk	MM
Badger (C) Tracked Transport C.blk	MM
Badger (C) Tracked Transport D.blk	MM
Badger (C) Tracked Transport E.blk	MM
Badger (C) Tracked Transport F.blk	MM
Badger (C) Tracked Transport H.blk	MM
Badger (C) Tracked Transport Prime.blk	MM
Badger Tracked Transport A.blk	MM
Badger Tracked Transport B.blk	MM
Badger Tracked Transport C.blk	MM
Badger Tracked Transport D.blk	MM
Badger Tracked Transport E.blk	MM
Badger Tracked Transport F.blk	MM
Badger Tracked Transport G.blk	MM
Badger Tracked Transport Prime.blk	MM
Badger Tracked Transport R.blk	MWL
Bakeneko BKN-1K.mtf	MM
Balac Strike VTOL (Hybrid).blk	MM
Balac Strike VTOL (LRM).blk	MM
Balac Strike VTOL (Spotter).blk	MM
Balac Strike VTOL.blk	MM
Balius A.mtf	MM
Balius B.mtf	MM
Balius C.mtf	MM
Balius D.mtf	MM
Balius E.mtf	MM
Balius Prime.mtf	MM
Balius U.mtf	MM
Ballista Artillery Trailer (Standard).blk	MM
Ballista Self Propelled Artillery Tank.blk	MM
Bandersnatch BNDR-01A.mtf	MM
Bandersnatch BNDR-01Ar.mtf	MM
Bandersnatch BNDR-01B.mtf	MM
Bandersnatch BNDR-01D.mtf	MWL
Bandersnatch BNDR-01D1.mtf	MWL
Bandersnatch BNDR-01WB.mtf	MWL
Bandersnatch BNDR-03B.mtf	MWL
Bandersnatch BNDR-9M.mtf	MWL
Bandersnatch Horus.mtf	MM
Bandit (C) Hovercraft A.blk	MM
Bandit (C) Hovercraft B.blk	MM
Bandit (C) Hovercraft C.blk	MM
Bandit (C) Hovercraft D.blk	MM
Bandit (C) Hovercraft E.blk	MM
Bandit (C) Hovercraft F.blk	MM
Bandit (C) Hovercraft G.blk	MM
Bandit (C) Hovercraft H.blk	MM
Bandit (C) Hovercraft Prime.blk	MM
Bandit Hovercraft A.blk	MM
Bandit Hovercraft B.blk	MM
Bandit Hovercraft C.blk	MM
Bandit Hovercraft D.blk	MM
Bandit Hovercraft E.blk	MM
Bandit Hovercraft F.blk	MM
Bandit Hovercraft G.blk	MM
Bandit Hovercraft H.blk	MM
Bandit Hovercraft I.blk	MM
Bandit Hovercraft Prime.blk	MM
Bandit Hovercraft R.blk	MWL
Bandit Mk II.blk	MM
Bandit Warthog.blk	MM
Banshee BNC-11X.mtf	MM
Banshee BNC-12S.mtf	MWL
Banshee BNC-1DM.mtf	MWL
Banshee BNC-1E.mtf	MM
Banshee BNC-20SC.mtf	MWL
Banshee BNC-3E.mtf	MM
Banshee BNC-3M.mtf	MM
Banshee BNC-3MC.mtf	MM
Banshee BNC-3Mr.mtf	MM
Banshee BNC-3Q.mtf	MM
Banshee BNC-3S Reinesblatt.mtf	MM
Banshee BNC-3S.mtf	MM
Banshee BNC-5S (Sawyer).mtf	MM
Banshee BNC-5S (Vandergriff).mtf	MM
Banshee BNC-5S.mtf	MM
Banshee BNC-6S.mtf	MM
Banshee BNC-6SB.mtf	MWL
Banshee BNC-7S.mtf	MM
Banshee BNC-8S.mtf	MM
Banshee BNC-8X.mtf	MWL
Banshee BNC-9S.mtf	MM
Banshee BNC-9S2.mtf	MM
Banzai BNZ-X.mtf	MM
Bardiche Heavy Strike Tank (Minesweeper).blk	MM
Bardiche Heavy Strike Tank (Standard).blk	MM
Barghest BGS-1T.mtf	MM
Barghest BGS-1Tr.mtf	MWL
Barghest BGS-1V.mtf	MWL
Barghest BGS-2T.mtf	MM
Barghest BGS-3T.mtf	MM
Barghest BGS-4T.mtf	MM
Barghest BGS-4X.mtf	MM
Barghest BGS-7S.mtf	MM
Barouche Hovercraft.blk	MM
BARS (Bushido).blk	MWL
BARS (Cell G).blk	MWL
BARS (Cell).blk	MWL
BARS (X).blk	MWL
BARS C.blk	MWL
BARS.blk	MWL
Base A.blk	MWL
Base VC.blk	MWL
Bashkir A.blk	MWL
Bashkir B.blk	MWL
Bashkir C.blk	MWL
Bashkir D.blk	MWL
Bashkir F.blk	MWL
Bashkir Prime.blk	MWL
Battle Cobra A.mtf	MM
Battle Cobra B.mtf	MM
Battle Cobra BTL-C-2O.mtf	MM
Battle Cobra BTL-C-2OA.mtf	MM
Battle Cobra BTL-C-2OB.mtf	MM
Battle Cobra BTL-C-2OC.mtf	MM
Battle Cobra BTL-C-2OD.mtf	MM
Battle Cobra BTL-C-2OE.mtf	MM
Battle Cobra BTL-C-2OF.mtf	MM
Battle Cobra C.mtf	MM
Battle Cobra F.mtf	MM
Battle Cobra H.mtf	MM
Battle Cobra Prime.mtf	MM
Battle Cobra X.mtf	MM
Battle Hawk BH-K305.mtf	MM
Battle Hawk BH-K306 Skobel.mtf	MWL
Battle Hawk BH-K306.mtf	MM
Battle Hawk BH-K308.mtf	MWL
BattleAxe BKX-1X.mtf	MM
BattleAxe BKX-7K.mtf	MM
BattleAxe BKX-7NC.mtf	MM
BattleAxe BKX-8D.mtf	MM
Battleaxe BKX-8IF.mtf	MWL
Battleaxe BKX-8L.mtf	MWL
BattleMaster BLR-10K.mtf	MWL
BattleMaster BLR-10S.mtf	MM
BattleMaster BLR-10S2.mtf	MM
BattleMaster BLR-1D.mtf	MM
BattleMaster BLR-1G Red Corsair.mtf	MM
BattleMaster BLR-1G.mtf	MM
BattleMaster BLR-1Gb.mtf	MM
BattleMaster BLR-1Gbc.mtf	MM
BattleMaster BLR-1Gc.mtf	MM
BattleMaster BLR-1Gd.mtf	MM
BattleMaster BLR-1G-DC.mtf	MM
BattleMaster BLR-1GHE HellSinger.mtf	MM
BattleMaster BLR-1S.mtf	MM
BattleMaster BLR-2C.mtf	MM
Battlemaster BLR-3KA.mtf	MWL
BattleMaster BLR-3M (Rogers).mtf	MM
BattleMaster BLR-3M.mtf	MM
BattleMaster BLR-3S.mtf	MM
Battlemaster BLR-3SS.mtf	MWL
BattleMaster BLR-4L.mtf	MM
BattleMaster BLR-4S Calvin II.mtf	MM
BattleMaster BLR-4S Calvin.mtf	MM
BattleMaster BLR-4S.mtf	MM
Battlemaster BLR-4SB.mtf	MWL
BattleMaster BLR-5M.mtf	MM
Battlemaster BLR-5R.mtf	MWL
BattleMaster BLR-6X.mtf	MM
Battlemaster BLR-7L.mtf	MWL
BattleMaster BLR-8S.mtf	MWL
BattleMaster BLR-CM.mtf	MM
BattleMaster BLR-CMr.mtf	MWL
BattleMaster BLR-K3.mtf	MM
BattleMaster BLR-K4.mtf	MM
BattleMaster BLR-K5.mtf	MWL
BattleMaster BLR-K7.mtf	MWL
BattleMaster BLR-M3.mtf	MM
BattleMaster C.mtf	MM
BattleMech Recovery Vehicle.blk	MM
Batu A.blk	MWL
Batu B.blk	MWL
Batu C.blk	MWL
Batu D.blk	MWL
Batu J.blk	MWL
Batu Prime.blk	MWL
Beagle (Sealed).blk	MM
Beagle Hover Scout (3067).blk	MWL
Beagle Hover Scout (C3i).blk	MM
Beagle Hover Scout (Interdictor).blk	MWL
Beagle Hover Scout (LRRP).blk	MM
Beagle Hover Scout (TAG).blk	MM
Beagle.blk	MM
Bear Cub .mtf	MM
Bear Cub 2.mtf	MM
Bear Cub 3.mtf	MM
Bear Cub 4.mtf	MWL
Bear Cub 5.mtf	MWL
Bear Cub 6.mtf	MWL
Behemoth (Stone Rhino) 2.mtf	MM
Behemoth (Stone Rhino) 3.mtf	MM
Behemoth (Stone Rhino) 4.mtf	MM
Behemoth (Stone Rhino) 5.mtf	MM
Behemoth (Stone Rhino) 6.mtf	MM
Behemoth (Stone Rhino).mtf	MM
Behemoth Heavy Tank (Armor).blk	MM
Behemoth Heavy Tank (Flamer).blk	MM
Behemoth Heavy Tank (Kurita).blk	MM
Behemoth Heavy Tank (Tom-Tom).blk	MWL
Behemoth Heavy Tank.blk	MM
Behemoth II Heavy Tank (Standard).blk	MM
Behemoth II Heavy Tank (Support).blk	MM
Behemoth II Tank.blk	MWL
Bellerophon BEL-1X.mtf	MM
Bellona  Hover Tank (Laser).blk	MM
Bellona Hover Tank.blk	MM
Bengal A.blk	MWL
Bengal B.blk	MWL
Bengal.blk	MWL
Beowulf BEO-12.mtf	MM
Beowulf BEO-14.mtf	MM
Beowulf BEO-X-7a.mtf	MM
Beowulf C.mtf	MM
Beowulf IIC.mtf	MM
Berserker  BRZ-A3H.mtf	MWL
Berserker BRZ-A3.mtf	MM
Berserker BRZ-A4.mtf	MWL
Berserker BRZ-AJ.mtf	MWL
Berserker BRZ-B3.mtf	MM
Berserker BRZ-C3.mtf	MM
Berserker BRZ-D4.mtf	MM
Bishamon BSN-3K.mtf	MM
Bishamon BSN-4K.mtf	MM
Bishamon BSN-5KC.mtf	MM
Bishamon BSN-6K.mtf	MWL
Bishop Transport VTOL (Standard).blk	MM
Black Hawk (Nova) A.mtf	MM
Black Hawk (Nova) B.mtf	MM
Black Hawk (Nova) C.mtf	MM
Black Hawk (Nova) D.mtf	MM
Black Hawk (Nova) E.mtf	MM
Black Hawk (Nova) F.mtf	MM
Black Hawk (Nova) H.mtf	MM
Black Hawk (Nova) I.mtf	MM
Black Hawk (Nova) Prime.mtf	MM
Black Hawk (Nova) S.mtf	MM
Black Hawk (Nova) T.mtf	MM
Black Hawk (Nova) U.mtf	MM
Black Hawk 2.mtf	MM
Black Hawk 3.mtf	MM
Black Hawk.mtf	MM
Black Hawk-KU BHKU-O Albert.mtf	MM
Black Hawk-KU BHKU-O.mtf	MM
Black Hawk-KU BHKU-OA.mtf	MM
Black Hawk-KU BHKU-OB.mtf	MM
Black Hawk-KU BHKU-OC.mtf	MM
Black Hawk-KU BHKU-OD.mtf	MM
Black Hawk-KU BHKU-OE.mtf	MM
Black Hawk-KU BHKU-OF.mtf	MM
Black Hawk-KU BHKU-OG.mtf	MM
Black Hawk-KU BHKU-OK.mtf	MWL
Black Hawk-KU BHKU-OR.mtf	MM
Black Hawk-KU BHKU-OU.mtf	MM
Black Hawk-KU BHKU-OX.mtf	MM
Black Knight BL-10-KNT Ross.mtf	MM
Black Knight BL-12-KNT.mtf	MM
Black Knight BL13-KNT.mtf	MWL
Black Knight BL15-KNT.mtf	MWL
Black Knight BL16-KNT.mtf	MWL
Black Knight BL-20-KNT.mtf	MWL
Black Knight BL6b-KNT.mtf	MM
Black Knight BL-6b-KNT.mtf	MWL
Black Knight BL-6-KLC.mtf	MWL
Black Knight BL-6-KNT Ian.mtf	MM
Black Knight BL-6-KNT.mtf	MM
Black Knight BL-6-RR.mtf	MM
Black Knight BL-7-KNT.mtf	MM
Black Knight BL-7-KNT-L.mtf	MM
Black Knight BL-9-KNT.mtf	MM
Black Knight BL-CG-KNT.mtf	MWL
Black Knight BL-KG-KNT.mtf	MWL
Black Knight BLK-NT-2Y.mtf	MM
Black Knight BLK-NT-3A.mtf	MM
Black Knight BLK-NT-3B.mtf	MM
Black Knight BLK-NT-4D.mtf	MM
Black Knight BLK-NT-5H.mtf	MM
Black Knight BL-KNT-IIC.mtf	MWL
Black Lanner A.mtf	MM
Black Lanner B JF (MWL).mtf	MWL
Black Lanner B.mtf	MM
Black Lanner C.mtf	MM
Black Lanner D.mtf	MM
Black Lanner E.mtf	MM
Black Lanner H.mtf	MM
Black Lanner Prime.mtf	MM
Black Lanner X.mtf	MM
Black Watch BKW-7D.mtf	MWL
Black Watch BKW-7R.mtf	MM
Black Watch BKW-7W.mtf	MWL
Black Watch BKW-8R.mtf	MWL
Black Watch BKW-9R.mtf	MM
Black Wolf Battle Armor(ER Pulse).blk	MM
Black Wolf Battle Armor(Flamer).blk	MM
Black Wolf Battle Armor(Heavy Mortar).blk	MM
Black Wolf Battle Armor(LBX).blk	MM
Black Wolf Battle Armor(Plasma).blk	MM
Blackjack BJ-1.mtf	MM
Blackjack BJ-1DB.mtf	MM
Blackjack BJ-1DC.mtf	MM
Blackjack BJ-1X.mtf	MM
Blackjack BJ-2.mtf	MM
Blackjack BJ-2DB.mtf	MWL
Blackjack BJ2-O.mtf	MM
Blackjack BJ2-OA.mtf	MM
Blackjack BJ2-OB.mtf	MM
Blackjack BJ2-OC.mtf	MM
Blackjack BJ2-OD.mtf	MM
Blackjack BJ2-OE.mtf	MM
Blackjack BJ2-OF.mtf	MM
Blackjack BJ2-OG.mtf	MM
Blackjack BJ2-OH.mtf	MWL
Blackjack BJ2-OK.mtf	MWL
Blackjack BJ2-OM.mtf	MWL
Blackjack BJ2-OP.mtf	MWL
Blackjack BJ2-OR.mtf	MM
Blackjack BJ2-OU.mtf	MM
Blackjack BJ2-OX.mtf	MM
Blackjack BJ-2r.mtf	MM
Blackjack BJ-3.mtf	MM
Blackjack BJ-3L.mtf	MWL
Blackjack BJ-4.mtf	MM
Blackjack BJ-5.mtf	MWL
Blackjack BJ-8D.mtf	MWL
Blackwasp Mk 30.blk	MWL
Blade BLD-7R.mtf	MM
Blade BLD-XL.mtf	MM
Blade BLD-XS.mtf	MM
Blade BLD-XX.mtf	MM
Blitzkrieg BTZ-3F.mtf	MM
Blitzkrieg BTZ-4F.mtf	MM
Blitzkrieg BTZ-5F.mtf	MWL
Blitzkrieg BTZ-6F.mtf	MWL
Blizzard Hover Transport (Black).blk	MWL
Blizzard Hover Transport (SRM).blk	MM
Blizzard Hover Transport Black Blizzard.blk	MM
Blizzard Hover Transport.blk	MM
Blood Asp A.mtf	MM
Blood Asp B.mtf	MM
Blood Asp C.mtf	MM
Blood Asp D.mtf	MM
Blood Asp E.mtf	MM
Blood Asp F.mtf	MM
Blood Asp G.mtf	MM
Blood Asp I.mtf	MWL
Blood Asp J.mtf	MWL
Blood Asp Prime.mtf	MM
Blood Kite 2.mtf	MM
Blood Kite.mtf	MM
Blood Reaper .mtf	MM
Blood Reaper 2.mtf	MM
Bloodhound B1-HND.mtf	MM
Bloodhound B2-HND.mtf	MM
Bloodhound B3-HND.mtf	MM
Bloodhound B4-HND.mtf	MWL
Bloodhound B5-HND.mtf	MWL
Blue Flame BLF-21.mtf	MM
Blue Flame BLF-23.mtf	MWL
Blue Flame BLF-25.mtf	MWL
Blue Flame BLF-40.mtf	MM
Bolla Stealth Tank A.blk	MM
Bolla Stealth Tank B.blk	MM
Bolla Stealth Tank C.blk	MM
Bolla Stealth Tank Comminus.blk	MM
Bolla Stealth Tank D.blk	MM
Bolla Stealth Tank Dominus.blk	MM
Bolla Stealth Tank Eminus.blk	MWL
Bolla Stealth Tank Infernus.blk	MM
Bolla Stealth Tank Invictus.blk	MM
Bolla Stealth Tank Prime.blk	MM
Bombard BMB-010.mtf	MM
Bombard BMB-013.mtf	MM
Bombard BMB-1X.mtf	MM
Bombardier BMB-05A.mtf	MM
Bombardier BMB-10D.mtf	MM
Bombardier BMB-12D.mtf	MM
Bombardier BMB-14C.mtf	MM
Bombardier BMB-14CS2.mtf	MWL
Bombardier BMB-14K.mtf	MM
Bombardier BMB-18C.mtf	MWL
Bombardier IIC.mtf	MWL
Bombardier IIC-R.mtf	MWL
Bowman 2.mtf	MM
Bowman 3.mtf	MM
Bowman 4.mtf	MM
Bowman.mtf	MM
Brahma BRM-5A.mtf	MM
Brahma BRM-5B.mtf	MM
Brahma BRM-6A.mtf	MWL
Brigand LDT-1.mtf	MM
Brigand LDT-X1.mtf	MM
Brigand LDT-X2.mtf	MM
Brigand LDT-X3.mtf	MM
Brigand LDT-X4.mtf	MM
Bruin .mtf	MM
Bruin 2.mtf	MM
Brunel Dump Truck AC20.blk	MM
Brunel Dump Truck LRM.blk	MM
Brunel Dump Truck.blk	MM
Brutus Assault Tank (HPPC).blk	MM
Brutus Assault Tank (LRM).blk	MM
Brutus Assault Tank (MML).blk	MWL
Brutus Assault Tank (PPC 2).blk	MM
Brutus Assault Tank (PPC).blk	MM
Brutus Assault Tank.blk	MM
Buccaneer BCN-3M.mtf	MWL
Buccaneer BCN-3R.mtf	MM
Buccaneer BCN-3X.mtf	MWL
Buccaneer BCN-4R.mtf	MWL
Buccaneer BCN-5W.mtf	MM
Buccaneer BCN-6W.mtf	MM
Buffalo Drone Bomb.blk	MM
Buffel VII Engineering Support Vehicle (Cargo).blk	MM
Buffel VII Engineering Support Vehicle Reverse Buffel.blk	MM
Buffel VII Engineering Support Vehicle.blk	MM
Buffel VIII Engineering Support Vehicle.blk	MM
Buitre Heavy VTOL.blk	MWL
Bulldog Medium Tank (AC2).blk	MM
Bulldog Medium Tank (BLAZER).blk	MWL
Bulldog Medium Tank (Cell).blk	MM
Bulldog Medium Tank (HVAC).blk	MWL
Bulldog Medium Tank (LPPC).blk	MWL
Bulldog Medium Tank (LRM).blk	MM
Bulldog Medium Tank (Stealth).blk	MWL
Bulldog Medium Tank.blk	MM
Bullet Suicide Drone.blk	MM
Bulwark Assault Vehicle (Original).blk	MM
Bulwark Assault Vehicle (Standardl).blk	MM
Buraq Fast Battle Armor (HK).blk	MM
Buraq Fast Battle Armor (Standard).blk	MM
Buraq Fast Battle Armor (Support).blk	MM
Burke Defense Tank (HPPC).blk	MM
Burke Defense Tank (Royal).blk	MM
Burke Defense Tank.blk	MM
Burke II Superheavy Tank (Standard).blk	MM
Burke IIC.blk	MWL
Burrock 2.mtf	MM
Burrock.mtf	MM
Bushwacker BSW-L1.mtf	MM
Bushwacker BSW-S2.mtf	MM
Bushwacker BSW-S2r.mtf	MM
Bushwacker BSW-S5.mtf	MWL
Bushwacker BSW-X1.mtf	MM
Bushwacker BSW-X2.mtf	MM
Bushwacker BSW-X3.mtf	MWL
Bushwacker BSW-X4.mtf	MWL
Buster Class HaulerMech BC XV (AC).mtf	MM
Buster Class HaulerMech BC XV (PPC).mtf	MM
Buster Class HaulerMech BC XV.mtf	MM
Buster XXI HaulerMech (Standard).mtf	MM
Cadaver CVR-A1.mtf	MM
Cadaver CVR-T1.mtf	MM
Caesar CES-3R Archangel.mtf	MM
Caesar CES-3R.mtf	MM
Caesar CES-3S.mtf	MM
Caesar CES-4R.mtf	MM
Caesar CES-4S.mtf	MM
Calliope CAL-1MAF.mtf	MM
Canis .mtf	MM
Canis 2.mtf	MM
Caravan Heavy Transport.blk	MM
Carbine ConstructionMech CON-1 (Rocket).mtf	MM
Carbine ConstructionMech CON-1.mtf	MM
Carbine ConstructionMech CON-7.mtf	MM
Carbine ConstructionMech CON-8.mtf	MM
Cardinal Transport (RAF).blk	MM
Cardinal Transport (Standard).blk	MM
Carnivore Assault Tank (HAG).blk	MM
Carnivore Assault Tank (Second Line).blk	MM
Carnivore Assault Tank.blk	MM
Carronade CRN-7M.mtf	MM
Carter MERV.blk	MM
Cataphract CTF-0X.mtf	MM
Cataphract CTF-1X.mtf	MM
Cataphract CTF-2X George.mtf	MM
Cataphract CTF-2X.mtf	MM
Cataphract CTF-3D.mtf	MM
Cataphract CTF-3L.mtf	MM
Cataphract CTF-3LL.mtf	MM
Cataphract CTF-3LV.mtf	MWL
Cataphract CTF-3X Sara.mtf	MM
Cataphract CTF-4L.mtf	MM
Cataphract CTF-4X.mtf	MM
Cataphract CTF-5D.mtf	MM
Cataphract CTF-5L.mtf	MWL
Cataphract CTF-5MOC Naomi.mtf	MM
Cataphract III CTF-3X.mtf	MWL
Cataphract III CTF-3XT.mtf	MWL
Catapult CPLT-7H.mtf	MWL
Catapult CPLT-8H.mtf	MWL
Catapult CPLT-A1.mtf	MM
Catapult CPLT-C1 Jenny.mtf	MM
Catapult CPLT-C1.mtf	MM
Catapult CPLT-C1b.mtf	MM
Catapult CPLT-C2.mtf	MM
Catapult CPLT-C2L.mtf	MWL
Catapult CPLT-C3.mtf	MM
Catapult CPLT-C4.mtf	MM
Catapult CPLT-C4C.mtf	MM
Catapult CPLT-C5.mtf	MM
Catapult CPLT-C5A.mtf	MM
Catapult CPLT-C6.mtf	MM
Catapult CPLT-C7.mtf	MWL
Catapult CPLT-C7A.mtf	MWL
Catapult CPLT-H2.mtf	MM
Catapult CPLT-K2.mtf	MM
Catapult CPLT-K2K.mtf	MM
Catapult CPLT-K3.mtf	MM
Catapult CPLT-K4.mtf	MM
Catapult CPLT-K5.mtf	MM
Catapult II CPLT-L7.mtf	MM
Catapult II CPLT-L7L.mtf	MM
Cattlemaster CTL-2 (Hunter).mtf	MM
Cattlemaster CTL-3R (Herder).mtf	MM
Cattlemaster RA-4 HerderMech.mtf	MM
Cauldron-Born (Ebon Jaguar) (Samantha).mtf	MM
Cauldron-Born (Ebon Jaguar) A.mtf	MM
Cauldron-Born (Ebon Jaguar) B.mtf	MM
Cauldron-Born (Ebon Jaguar) C.mtf	MM
Cauldron-Born (Ebon Jaguar) D.mtf	MM
Cauldron-Born (Ebon Jaguar) E.mtf	MM
Cauldron-Born (Ebon Jaguar) H.mtf	MM
Cauldron-Born (Ebon Jaguar) Prime.mtf	MM
Cauldron-Born (Ebon Jaguar) U.mtf	MM
Cauldron-Born (Ebon Jaguar) X.mtf	MM
Cauldron-Born HV.mtf	MWL
Cavalier [Flamer].blk	MM
Cavalier [Laser].blk	MM
Cavalier [MG].blk	MM
Cavalier [SRM].blk	MM
Cavalry (Inflitrator).blk	MM
Cavalry Attack Helicopter (Infantry).blk	MM
Cavalry Attack Helicopter (LRM).blk	MM
Cavalry Attack Helicopter (SRM).blk	MM
Cavalry Attack Helicopter (TAG).blk	MM
Cavalry Attack Helicopter Cadence Rain.blk	MM
Cavalry Attack Helicopter.blk	MM
Cave Lion (Standard).mtf	MM
Celerity CLR-02-X-D.mtf	MM
Centaur BattleArmor (Standard).blk	MM
Centipede Commando.blk	MM
Centipede Scout Car (SRM).blk	MM
Centipede Scout Car (TAG).blk	MM
Centipede Scout Car.blk	MM
Centurion CN10-B.mtf	MWL
Centurion CN10-B1.mtf	MWL
Centurion CN10-B2.mtf	MWL
Centurion CN11-O.mtf	MM
Centurion CN11-OA.mtf	MM
Centurion CN11-OB.mtf	MM
Centurion CN11-OC.mtf	MM
Centurion CN11-OD.mtf	MM
Centurion CN11-OE.mtf	MM
Centurion CN9-A.mtf	MM
Centurion CN9-AH.mtf	MM
Centurion CN9-AL.mtf	MM
Centurion CN9-Ar.mtf	MM
Centurion CN9-D.mtf	MM
Centurion CN9-D3.mtf	MM
Centurion CN9-D3D.mtf	MM
Centurion CN9-D4D.mtf	MM
Centurion CN9-D5.mtf	MM
Centurion CN9-D6.mtf	MWL
Centurion CN9-D9.mtf	MM
Centurion CN9-Da.mtf	MM
Centurion CN9-H.mtf	MM
Centurion CN9-MV.mtf	MWL
Centurion CN9-S.mtf	MWL
Centurion CN9-SG.mtf	MWL
Centurion CN9-SX.mtf	MWL
Centurion CN9-YLW Yen Lo Wang.mtf	MM
Centurion CN9-YLW.mtf	MWL
Centurion CN9-YLW2.mtf	MM
Centurion CNT-1D.blk	MWL
Centurion CNT-3S.blk	MWL
Cephalus A.mtf	MM
Cephalus B.mtf	MM
Cephalus C.mtf	MM
Cephalus D.mtf	MM
Cephalus E.mtf	MM
Cephalus Prime.mtf	MM
Cephalus U.mtf	MM
Cerberus MR-5M.mtf	MM
Cerberus MR-6B.mtf	MM
Cerberus MR-7B.mtf	MWL
Cerberus MR-V2.mtf	MM
Cerberus MR-V3.mtf	MM
Cerberus MR-V3C.mtf	MWL
Cerberus MR-V5C.mtf	MWL
Cerberus MR-W2.mtf	MWL
Cestus CTS-6RK.mtf	MWL
Cestus CTS-6X.mtf	MM
Cestus CTS-6Y.mtf	MM
Cestus CTS-6Z.mtf	MM
Cestus CTS-7A.mtf	MM
Cestus CTS-7CS.mtf	MWL
Cestus CTS-7D.mtf	MWL
Cestus CTS-7S.mtf	MWL
Chaeronea 2.blk	MWL
Chaeronea 3.blk	MWL
Chaeronea.blk	MWL
Chaffee Servicemech BT1.mtf	MM
Chalchiuhtotolin Support Tank (Bombast Laser).blk	MM
Chalchiuhtotolin Support Tank (Chemical Laser).blk	MM
Chalchiuhtotolin Support Tank (XL).blk	MM
Chalchiuhtotolin Support Tank.blk	MM
Challenger MBT XV.blk	MM
Challenger MBT XVc.blk	MM
Challenger X MBT.blk	MM
Challenger XI MBT.blk	MM
Challenger XII MBT.blk	MM
Challenger XIVs MBT.blk	MM
Chameleon CLN-4V.mtf	MM
Chameleon CLN-7V.mtf	MM
Chameleon CLN-7W.mtf	MM
Chameleon CLN-7Z.mtf	MM
Chameleon Q-'Mech CLN-7VQ.mtf	MM
Champion C.mtf	MM
Champion CHP-1CS.mtf	MWL
Champion CHP-1N.mtf	MM
Champion CHP-1N2.mtf	MM
Champion CHP-1Nb.mtf	MM
Champion CHP-2N.mtf	MM
Champion CHP-3D.mtf	MWL
Champion CHP-3N.mtf	MM
Champion CHP-3P.mtf	MM
Champion CHP-4C.mtf	MWL
Champion CHP-4C3.mtf	MWL
Champion II CHM-3W.mtf	MWL
Champion II CHM-3WAP.mtf	MWL
Champion IIC.mtf	MWL
Chaparral (CASE).blk	MM
Chaparral (ERML).blk	MM
Chaparral (MG).blk	MM
Chaparral (SRM).blk	MM
Chaparral.blk	MM
Charger CGR-1A1.mtf	MM
Charger CGR-1A5.mtf	MM
Charger CGR-1A9.mtf	MM
Charger CGR-1L.mtf	MM
Charger CGR-1RA.mtf	MWL
Charger CGR-1X1.mtf	MM
Charger CGR-2A2.mtf	MM
Charger CGR-2RA.mtf	MWL
Charger CGR-3K.mtf	MM
Charger CGR-3Kr.mtf	MM
Charger CGR-6J.mtf	MWL
Charger CGR-6K.mtf	MWL
Charger CGR-7K.mtf	MWL
Charger CGR-A9R.mtf	MWL
Charger CGR-C.mtf	MM
Charger CGR-KMZ.mtf	MM
Charger CGR-SA5.mtf	MM
Charger CGR-SB.mtf	MM
Charonea 2.blk	MWL
Charonea 3.blk	MWL
Charonea 4.blk	MWL
Charonea 5.blk	MWL
Charonea.blk	MWL
Cheetah F-10.blk	MWL
Cheetah F-11.blk	MWL
Cheetah F-11-R.blk	MWL
Cheetah F-11-RR.blk	MWL
Cheetah F-12-S.blk	MWL
Cheetah F-13.blk	MWL
Cheetah F-14-S.blk	MWL
Cheetah OF-17.blk	MWL
Chevalier Light Tank (BAP).blk	MM
Chevalier Light Tank (MML).blk	MM
Chevalier Light Tank (Speed).blk	MM
Chevalier Light Tank (VSPL).blk	MWL
Chevalier Light Tank.blk	MM
Chimera CMA-1S.mtf	MM
Chimera CMA-2K.mtf	MWL
Chimera CMA-2S.mtf	MWL
Chimera CMA-3A.mtf	MWL
Chimera CMA-C.mtf	MM
Chimera CMA-K.mtf	MWL
Chimera CMA-S.mtf	MWL
Chippewa CHP-W10.blk	MWL
Chippewa CHP-W5.blk	MWL
Chippewa CHP-W5b.blk	MWL
Chippewa CHP-W7.blk	MWL
Chippewa CHP-W7T.blk	MWL
Chippewa CHP-W8.blk	MWL
Chippewa IIC.blk	MWL
Churchill Mk XX (AC 20).blk	MWL
Churchill Mk XX (Gauss).blk	MWL
Churchill Mk XX.blk	MWL
Cicada CDA-2A.mtf	MM
Cicada CDA-2B.mtf	MM
Cicada CDA-3C.mtf	MM
Cicada CDA-3F.mtf	MM
Cicada CDA-3G.mtf	MM
Cicada CDA-3M.mtf	MM
Cicada CDA-3MA.mtf	MM
Cicada CDA-3P.mtf	MM
Cicada CDA-3T.mtf	MWL
Cicada CDA-6P.mtf	MWL
Cizin (Standard).blk	MM
Cizin (Support).blk	MM
Clan Medium BA (Bar).blk	MM
Clan Medium BA (Rache).blk	MM
Clan Medium BA (Rapid).blk	MM
Clan Medium BA (Volk).blk	MM
Claymore G.blk	MWL
Claymore.blk	MWL
Clint CLNT-1-2R.mtf	MM
Clint CLNT-2-2R.mtf	MWL
Clint CLNT-2-3T Denton.mtf	MM
Clint CLNT-2-3T.mtf	MM
Clint CLNT-2-3U.mtf	MM
Clint CLNT-2-3UL.mtf	MM
Clint CLNT-2-4T.mtf	MM
Clint CLNT-2-V.mtf	MWL
Clint CLNT-3-3T.mtf	MM
Clint CLNT-5U.mtf	MM
Clint CLNT-6S.mtf	MM
Clint CLNT-6SS.mtf	MWL
Clint IIC .mtf	MM
Clint IIC 2.mtf	MM
Clint IIC 2R.mtf	MWL
Cobra CBR-02.mtf	MM
Cobra CBR-02W.mtf	MWL
Cobra CBR-03.mtf	MM
Cobra CBR-03S.mtf	MWL
Cobra CBR-05.mtf	MWL
Cobra Transport VTOL (Command).blk	MM
Cobra Transport VTOL (M.A.S.H.).blk	MM
Cobra Transport VTOL.blk	MM
Colossus CL-P3.mtf	MM
Colossus CLS-4S.mtf	MM
Colossus CLS-5S.mtf	MM
Commando COM-1A.mtf	MM
Commando COM-1B.mtf	MM
Commando COM-1C.mtf	MM
Commando COM-1D.mtf	MM
Commando COM-2D.mtf	MM
Commando COM-2Dr.mtf	MM
Commando COM-2N.mtf	MWL
Commando COM-3A.mtf	MM
Commando COM-4H.mtf	MM
Commando COM-5S.mtf	MM
Commando COM-7B.mtf	MM
Commando COM-7S.mtf	MM
Commando COM-7S2 Freyr.mtf	MM
Commando COM-8S.mtf	MM
Commando COM-8T.mtf	MWL
Commando COM-9D.mtf	MWL
Commando COM-9DA.mtf	MWL
Commando COM-9S.mtf	MWL
Commando IIC .mtf	MM
Condor (Upgrade Laser).blk	MM
Condor (Upgrade).blk	MM
Condor Heavy Hover Tank (C3i).blk	MWL
Condor Heavy Hover Tank (Davion).blk	MM
Condor Heavy Hover Tank (FCE Davion).blk	MWL
Condor Heavy Hover Tank (FCE Liao).blk	MWL
Condor Heavy Hover Tank (FCE).blk	MWL
Condor Heavy Hover Tank (Fission).blk	MM
Condor Heavy Hover Tank (Flamer).blk	MM
Condor Heavy Hover Tank (Laser Upgrade).blk	MM
Condor Heavy Hover Tank (Laser).blk	MM
Condor Heavy Hover Tank (Liao).blk	MM
Condor Heavy Hover Tank.blk	MM
Condor Multi-Purpose Tank.blk	MWL
Constable Pacification Suit (ECM).blk	MM
Constable Pacification Suit (Imp Sensors).blk	MM
Constable Pacification Suit (LMG).blk	MM
Constable Pacification Suit (SRM).blk	MM
Constable Pacification Suit (TAG).blk	MM
Coolant Truck (Hover).blk	MM
Coolant Truck (Tracked).blk	MM
Coolant Truck 135-K.blk	MM
Copper SecurityMech CPK-19.mtf	MM
Copperhead CPR-HD-002.mtf	MM
Copperhead CPR-HD-003.mtf	MM
Copperhead CPR-HD-004.mtf	MM
Corax CRX-O.blk	MWL
Corax CRX-OA.blk	MWL
Corax CRX-OB.blk	MWL
Corax CRX-OC.blk	MWL
Corona (SRM) Elite.blk	MWL
Corona Elite.blk	MWL
Corona Heavy Battle Armor (SRM).blk	MM
Corona Heavy Battle Armor.blk	MM
Corsair CSR-V12.blk	MWL
Corsair CSR-V12b.blk	MWL
Corsair CSR-V12M.blk	MWL
Corsair CSR-V14.blk	MWL
Corsair CSR-V18.blk	MWL
Corsair CSR-V20.blk	MWL
Corsair CSR-X12 Rigid Night.blk	MWL
Corvis .mtf	MM
Corvis 2.mtf	MM
Cossack C-1FC.mtf	MM
Cossack C-SK1.mtf	MM
Cossack C-SK2.mtf	MWL
Cougar A.mtf	MM
Cougar B.mtf	MM
Cougar C.mtf	MM
Cougar D.mtf	MM
Cougar E.mtf	MM
Cougar F.mtf	MM
Cougar G.mtf	MM
Cougar H.mtf	MM
Cougar I.mtf	MM
Cougar Prime.mtf	MM
Cougar X 2.mtf	MM
Cougar X 3.mtf	MM
Cougar X.mtf	MM
Cougar Z.mtf	MWL
Cougar-XR.mtf	MM
Coyotl A.mtf	MM
Coyotl Prime.mtf	MM
Crab CRB-20.mtf	MM
Crab CRB-27.mtf	MM
Crab CRB-27b.mtf	MM
Crab CRB-27CS.mtf	MWL
Crab CRB-27L.mtf	MWL
Crab CRB-27sl.mtf	MM
Crab CRB-29L.mtf	MWL
Crab CRB-30.mtf	MM
Crab CRB-33.mtf	MWL
Crab CRB-45.mtf	MM
Crab CRB-65.mtf	MWL
Crab CRB-C.mtf	MM
Crab IIC 3H.mtf	MWL
Crab IIC.mtf	MWL
Crane Heavy Transport (Standard).blk	MM
Crimson Hawk .mtf	MM
Crimson Hawk 2.mtf	MM
Crimson Hawk 3.mtf	MM
Crimson Hawk 4.mtf	MM
Crimson Langur  Prime.mtf	MM
Crimson Langur A.mtf	MM
Crimson Langur B.mtf	MM
Crimson Langur C.mtf	MM
Crimson Langur D.mtf	MM
Crimson Langur E.mtf	MM
Crimson Langur Prime.mtf	MWL
Crinos Mk I.blk	MWL
Crinos Mk II.blk	MWL
Crockett CRK-5003-0.mtf	MM
Crockett CRK-5003-1.mtf	MM
Crockett CRK-5003-1b.mtf	MM
Crockett CRK-5003-3.mtf	MM
Crockett CRK-5003-4.mtf	MM
Crockett CRK-5003-6.mtf	MWL
Crockett CRK-5003-7.mtf	MWL
Crockett CRK-5004-1.mtf	MM
Crockett CRK-5005-1.mtf	MM
Crockett IIC 2.mtf	MWL
Crockett IIC.mtf	MWL
Cronus CNS-10M.mtf	MWL
Cronus CNS-3M.mtf	MM
Cronus CNS-5M.mtf	MM
Cronus CNS-6M.mtf	MWL
Cronus CNS-TD9.mtf	MM
Cronus CRS-3M.mtf	MWL
Crossbow A.mtf	MM
Crossbow B.mtf	MM
Crossbow C.mtf	MM
Crossbow CRS-6B.mtf	MM
Crossbow CRS-6C.mtf	MM
Crossbow CRS-9A.mtf	MM
Crossbow CRS-X.mtf	MM
Crossbow D.mtf	MM
Crossbow E.mtf	MM
Crossbow H.mtf	MM
Crossbow Prime.mtf	MM
Crossbow U.mtf	MM
Crosscut ForestryMech ED-X4.mtf	MM
Crosscut LoggerMech ED-X2 (Flamer).mtf	MM
Crosscut LoggerMech ED-X2 (Rocket).mtf	MM
Crosscut LoggerMech ED-X2.mtf	MM
Crosscut LoggerMech ED-XX Ichabod.mtf	MM
Crow (Export).blk	MWL
Crow Scout Helicopter (C3).blk	MM
Crow Scout Helicopter (Export).blk	MM
Crow Scout Helicopter.blk	MM
Crusader CRD-2R.mtf	MM
Crusader CRD-3D.mtf	MM
Crusader CRD-3E.mtf	MWL
Crusader CRD-3K.mtf	MM
Crusader CRD-3L.mtf	MM
Crusader CRD-3R Crael.mtf	MM
Crusader CRD-3R.mtf	MM
Crusader CRD-4BR.mtf	MM
Crusader CRD-4D.mtf	MM
Crusader CRD-4K.mtf	MM
Crusader CRD-4L.mtf	MM
Crusader CRD-5K.mtf	MM
Crusader CRD-5M.mtf	MM
Crusader CRD-5S.mtf	MM
Crusader CRD-6M.mtf	MM
Crusader CRD-7KA.mtf	MWL
Crusader CRD-7L.mtf	MM
Crusader CRD-7L2.mtf	MWL
Crusader CRD-7W.mtf	MM
Crusader CRD-8L.mtf	MM
Crusader CRD-8S.mtf	MM
Crusader CRD-9M.mtf	MWL
Crusader CRD-9S.mtf	MWL
Cuchulainn Support Armor (Clan).blk	MM
Cuchulainn Support Armor (IS).blk	MM
Cudgel CDG-1B.mtf	MM
Cudgel CDG-2A.mtf	MM
Cudgel CDG-2B.mtf	MM
Cuirass CDR-1X.mtf	MM
Cuirass CDR-2BC.mtf	MM
Cuirass CDR-2X.mtf	MM
Culverin CLV-N A.mtf	MWL
Culverin CLV-N B.mtf	MWL
Culverin CLV-N Prime.mtf	MWL
Cyclops CP-10-HQ.mtf	MM
Cyclops CP-10-Q.mtf	MM
Cyclops CP-10-Z.mtf	MM
Cyclops CP-11-A.mtf	MM
Cyclops CP-11-A-DC.mtf	MM
Cyclops CP-11-B.mtf	MM
Cyclops CP-11-C.mtf	MM
Cyclops CP-11-C2.mtf	MM
Cyclops CP-11-C3.mtf	MM
Cyclops CP-11-CS.mtf	MWL
Cyclops CP-11-G.mtf	MM
Cyclops CP-11-H.mtf	MM
Cyclops CP-11-L.mtf	MWL
Cyclops CP-11-RK.mtf	MWL
Cyclops CP-12-F.mtf	MWL
Cyclops CP-12-G.mtf	MWL
Cyclops CP-12-K.mtf	MM
Cyclops CP-12-L.mtf	MWL
Cyclops CP-13-C.mtf	MWL
Cyclops CP-13-CH.mtf	MWL
Cygnus .mtf	MM
Cygnus 2.mtf	MM
Cygnus 3.mtf	MM
Cygnus 4.mtf	MM
Cyrano Gunship (Fury).blk	MM
Cyrano Gunship (ML).blk	MM
Cyrano Gunship (Plasma).blk	MM
Cyrano Gunship (Royal).blk	MM
Cyrano Gunship.blk	MM
Daboku DCMS-MX90-D.mtf	MM
Daedalus DAD-3C.mtf	MM
Daedalus DAD-3D.mtf	MM
Daedalus DAD-4A.mtf	MM
Daedalus DAD-4B.mtf	MM
Daedalus GTX2 (Militarized).mtf	MM
Daedalus GTX2A Stevedore.mtf	MM
Daedalus GTX2B Navvy.mtf	MM
Dagger DAR4-XP.blk	MWL
Dagger DARO-1.blk	MWL
Dagger DARO-1A.blk	MWL
Dagger DARO-1B.blk	MWL
Daikyu DAI-01.mtf	MM
Daikyu DAI-01B.mtf	MWL
Daikyu DAI-01r.mtf	MM
Daikyu DAI-02.mtf	MM
Daikyu DAI-03.mtf	MM
Daikyu Tabitha.mtf	MM
Daimyo DMO-1K.mtf	MM
Daimyo DMO-1K2 Al-Shahab.mtf	MM
Daimyo DMO-2K.mtf	MM
Daimyo DMO-4K.mtf	MM
Daimyo DMO-5K.mtf	MM
Daimyo DMO-6K.mtf	MWL
Daimyo DMO-6KC.mtf	MWL
Daimyo DMO-7K.mtf	MWL
Daimyo HQ 67-K.blk	MM
Daimyo HQ 67-K2.blk	MM
Daimyo HQ 67-R.blk	MM
Daishi (Dire Wolf)  Prime.mtf	MM
Daishi (Dire Wolf) A.mtf	MM
Daishi (Dire Wolf) B.mtf	MM
Daishi (Dire Wolf) C.mtf	MM
Daishi (Dire Wolf) D.mtf	MM
Daishi (Dire Wolf) E.mtf	MM
Daishi (Dire Wolf) H.mtf	MM
Daishi (Dire Wolf) Hohiro.mtf	MM
Daishi (Dire Wolf) Prometheus.mtf	MM
Daishi (Dire Wolf) S.mtf	MM
Daishi (Dire Wolf) U.mtf	MM
Daishi (Dire Wolf) W.mtf	MM
Daishi (Dire Wolf) Widowmaker.mtf	MM
Daishi (Dire Wolf) X.mtf	MM
Danai Arrow.blk	MM
Danai Support Vehicle.blk	MM
Dao Mk I.blk	MWL
Dao Mk II.blk	MWL
Dark Crow .mtf	MM
Dark Crow 2.mtf	MM
Dark Crow 3.mtf	MM
Dark Crow 4.mtf	MM
Dart DRT-3S.mtf	MM
Dart DRT-4S.mtf	MM
Dart DRT-6S.mtf	MM
Dart DRT-6T.mtf	MM
Darter Scout Car (BAP).blk	MM
Darter Scout Car (C3).blk	MM
Darter Scout Car (ECM).blk	MM
Darter Scout Car (SRM).blk	MM
Darter Scout Car.blk	MM
Dasher (Fire Moth) A.mtf	MM
Dasher (Fire Moth) Aletha.mtf	MM
Dasher (Fire Moth) B.mtf	MM
Dasher (Fire Moth) C.mtf	MM
Dasher (Fire Moth) D.mtf	MM
Dasher (Fire Moth) E.mtf	MM
Dasher (Fire Moth) F.mtf	MM
Dasher (Fire Moth) G.mtf	MM
Dasher (Fire Moth) H.mtf	MM
Dasher (Fire Moth) K.mtf	MM
Dasher (Fire Moth) Prime.mtf	MM
Dasher II 2.mtf	MM
Dasher II 3.mtf	MM
Dasher II 4.mtf	MM
Dasher II.mtf	MM
Deathstalker F-77.blk	MWL
Deathstalker F-78.blk	MWL
Deep Lord MilitiaMech RCL-Z1M.mtf	MM
Defiance  DFN-3S.mtf	MWL
Defiance DFC-O.blk	MWL
Defiance DFC-OA.blk	MWL
Defiance DFC-OB.blk	MWL
Defiance DFC-OC.blk	MWL
Defiance DFN-3C.mtf	MM
Defiance DFN-3S.mtf	MM
Defiance DFN-3T.mtf	MM
Deimos 2.mtf	MM
Deimos A.mtf	MM
Deimos B.mtf	MM
Deimos C.mtf	MM
Deimos D.mtf	MM
Deimos E.mtf	MM
Deimos Prime.mtf	MM
Deimos S.mtf	MM
Demolisher Heavy Tank (Apollo).blk	MWL
Demolisher Heavy Tank (Arrow IV).blk	MM
Demolisher Heavy Tank (Clan).blk	MM
Demolisher Heavy Tank (CS-KA).blk	MWL
Demolisher Heavy Tank (Defensive).blk	MM
Demolisher Heavy Tank (Gauss).blk	MM
Demolisher Heavy Tank (MRM).blk	MM
Demolisher Heavy Tank (Standard Mk. I).blk	MM
Demolisher Heavy Tank (Standard Mk. II).blk	MM
Demolisher Heavy Tank (Ultra).blk	MWL
Demolisher Heavy Tank II -X.blk	MM
Demolisher Heavy Tank.blk	MWL
Demolisher II Heavy Tank (MML).blk	MM
Demolisher II Heavy Tank (Thunderbolt).blk	MM
Demolisher II Heavy Tank (WoB).blk	MWL
Demolisher II Heavy Tank (X).blk	MWL
Demolisher II Heavy Tank.blk	MM
DemolitionMech WI-DM.mtf	MM
DemolitionMech WI-DM2.mtf	MM
Demon Medium Tank (Armor).blk	MM
Demon Medium Tank (Rifle).blk	MM
Demon Medium Tank.blk	MM
Demon Tank (3067).blk	MWL
Demon Tank (HGR).blk	MM
Demon Tank (Horned Demon).blk	MM
Demon Tank (PPC).blk	MM
Demon Tank (Royal).blk	MM
Demon Tank CX-2.blk	MM
Demon Tank.blk	MM
Demona Combat Transport (Standard).blk	MWL
Dervish DV-1S.mtf	MM
Dervish DV-6M.mtf	MM
Dervish DV-6Md.mtf	MM
Dervish DV-6Mr.mtf	MM
Dervish DV-7D.mtf	MM
Dervish DV-7DX.mtf	MWL
Dervish DV-8D.mtf	MM
Dervish DV-8D2 Lightbringer.mtf	MM
Dervish DV-9D.mtf	MM
Destrier Siege Vehicle (Standard).blk	MM
Deva C-DVA-O Achilleus.mtf	MM
Deva C-DVA-O Asmodaeus.mtf	MWL
Deva C-DVA-O Comminus.mtf	MWL
Deva C-DVA-O Dominus.mtf	MWL
Deva C-DVA-O Eminus.mtf	MWL
Deva C-DVA-O Exanimus.mtf	MWL
Deva C-DVA-O Infernus.mtf	MWL
Deva C-DVA-O Invictus.mtf	MM
Deva C-DVA-O Luminos.mtf	MWL
Deva C-DVA-OA Dominus.mtf	MM
Deva C-DVA-OB Infernus.mtf	MM
Deva C-DVA-OC Comminus.mtf	MM
Deva C-DVA-OD Luminos.mtf	MM
Deva C-DVA-OE Eminus.mtf	MM
Deva C-DVA-OS Caelestis.mtf	MM
Deva C-DVA-OU Exanimus.mtf	MM
Devastator DVS-1D.mtf	MM
Devastator DVS-2.mtf	MM
Devastator DVS-3.mtf	MM
Devastator DVS-3SB.mtf	MWL
Devastator DVS-4.mtf	MWL
Devastator DVS-4B.mtf	MWL
Devastator DVS-4D.mtf	MWL
Devastator DVS-TDF.mtf	MWL
Devastator DVS-X10 MUSE EARTH.mtf	MM
Devastator Heavy Tank.blk	MM
DI Morgan Assault Tank (Gauss).blk	MM
DI Morgan Assault Tank (LRM).blk	MM
DI Morgan Assault Tank.blk	MM
DI Multipurpose VTOL (Gunship).blk	MM
DI Multipurpose VTOL (Standard).blk	MM
DI Schmitt Tank (Standard).blk	MM
DI Schmitt Tank (Targetting Computer).blk	MM
Dig Lord MiningMech MOD RCL-4M.mtf	MM
Dig Lord MiningMech RCL-4.mtf	MM
Dig Lord RCL-Z1 Armed MiningMech.mtf	MM
Diomede D-M3D-3 ConstructionMech.mtf	MM
Diomede D-M3D-4 DemolitionMech.mtf	MM
Diomede D-M3D-M.mtf	MM
Diomedes (Ultra).blk	MWL
Diomedes.blk	MWL
Dire Wolf B.mtf	MWL
Dire Wolf HS.mtf	MWL
Djinn Battle Armor (Stealth).blk	MM
Djinn Battle Armor.blk	MM
Dola DOL-1A.mtf	MM
Dola DOL-1A1.mtf	MM
Dola DOL-1A2 Yoh Ti Ts'angs.mtf	MM
Doloire DLR-O.mtf	MM
Doloire DLR-OA.mtf	MM
Doloire DLR-OB.mtf	MM
Doloire DLR-OC.mtf	MM
Doloire DLR-OD.mtf	MM
Donar Assault Helicopter (Close Support).blk	MM
Donar Assault Helicopter (Recon).blk	MM
Donar Assault Helicopter.blk	MM
Dragon DRG-1C.mtf	MM
Dragon DRG-1N.mtf	MM
Dragon DRG-2Y Yoriyoshi.mtf	MM
Dragon DRG-5K-DC.mtf	MM
Dragon DRG-5N.mtf	MM
Dragon DRG-5Nr.mtf	MM
Dragon DRG-7N.mtf	MM
Dragon Fire DGR-3F.mtf	MM
Dragon Fire DGR-3F2.mtf	MWL
Dragon Fire DGR-4F.mtf	MM
Dragon Fire DGR-4L.mtf	MWL
Dragon Fire DGR-5C.mtf	MWL
Dragon Fire DGR-6FC.mtf	MM
Dragon Fire DGR-6FC2 (Gregory).mtf	MM
Dragon Fire DGR-8FC.mtf	MWL
Dragon Fire Kishi DGR-6FC2.mtf	MWL
Dragon II DRG-11K.mtf	MM
Dragon II DRG-11R.mtf	MM
Dragonfly (Viper) A.mtf	MM
Dragonfly (Viper) AP.mtf	MWL
Dragonfly (Viper) B.mtf	MM
Dragonfly (Viper) C.mtf	MM
Dragonfly (Viper) D.mtf	MM
Dragonfly (Viper) E.mtf	MM
Dragonfly (Viper) F.mtf	MM
Dragonfly (Viper) G.mtf	MM
Dragonfly (Viper) G.mtf	MWL
Dragonfly (Viper) H.mtf	MM
Dragonfly (Viper) I.mtf	MM
Dragonfly (Viper) Prime.mtf	MM
Dragonfly (Viper) S.mtf	MWL
Dragonfly (Viper) U.mtf	MM
Dragonfly (Viper) Z.mtf	MM
Dragoon AEM-01.mtf	MM
Dragoon AEM-02.mtf	MM
Dragoon AEM-03.mtf	MM
Dragoon AEM-04.mtf	MM
Drillson Heavy Hover Tank (ERLL).blk	MM
Drillson Heavy Hover Tank (MML).blk	MWL
Drillson Heavy Hover Tank (Sealed).blk	MM
Drillson Heavy Hover Tank (SRM).blk	MM
Drillson Heavy Hover Tank (SSRM).blk	MWL
Drillson Heavy Hover Tank (Streak).blk	MM
Drillson Heavy Hover Tank.blk	MM
Dromedary Water Transport .blk	MM
Duan Gung D9-G10.mtf	MM
Duan Gung D9-G12.mtf	MWL
Duan Gung D9-G9.mtf	MM
Durendal DND-5D.mtf	MWL
Durendal DND-5DE.mtf	MWL
Durendal DND-5DL.mtf	MWL
Durendal DND-6DE.mtf	MWL
Eagle EGL-1M.mtf	MM
Eagle EGL-2M.mtf	MM
Eagle EGL-3M.mtf	MM
Eagle EGL-4M.mtf	MWL
Eagle EGL-R10.blk	MWL
Eagle EGL-R16.blk	MWL
Eagle EGL-R4.blk	MWL
Eagle EGL-R6.blk	MWL
Eagle EGL-R6b.blk	MWL
Eagle EGL-R9.blk	MWL
Ebony MEB-10.mtf	MM
Ebony MEB-11.mtf	MM
Ebony MEB-12.mtf	MM
Ebony MEB-13.mtf	MM
Ebony MEB-9.mtf	MM
Eidolon C-EID-001.mtf	MM
Eisenfaust EFT-2.mtf	MM
Eisenfaust EFT-4J.mtf	MM
Eisenfaust EFT-7X.mtf	MM
Eisenfaust EFT-8X.mtf	MM
Eisensturm EST-O.blk	MWL
Eisensturm EST-OA.blk	MWL
Eisensturm EST-OB.blk	MWL
Eisensturm EST-OC.blk	MWL
Eisensturm EST-R3.blk	MWL
Eldingar Hover Sled (HumHov).blk	MM
Eldingar Hover Sled (Streak).blk	MM
Eldingar Hover Sled.blk	MM
Elemental (AP Gauss) Elite.blk	MWL
Elemental (ER Laser) Elite.blk	MWL
Elemental (Flamer) Elite.blk	MWL
Elemental (Headhunter) Elite.blk	MWL
Elemental (HMG) Elite.blk	MWL
Elemental (Laser) Elite.blk	MWL
Elemental (MG) Elite.blk	MWL
Elemental (Pulse Laser) Elite.blk	MWL
Elemental (TAG) Elite.blk	MWL
Elemental (TAG).blk	MWL
Elemental Battle Armor (Fire) [AP Gauss].blk	MM
Elemental Battle Armor (Fire) [Flamer].blk	MM
Elemental Battle Armor (Fire) [Pulse Laser].blk	MM
Elemental Battle Armor (Headhunter).blk	MM
Elemental Battle Armor (Space) [Flamer].blk	MM
Elemental Battle Armor (Space) [MG].blk	MM
Elemental Battle Armor (Space) [Pulse Laser].blk	MM
Elemental Battle Armor [AP Gauss].blk	MM
Elemental Battle Armor [ER Laser].blk	MM
Elemental Battle Armor [Flamer].blk	MM
Elemental Battle Armor [HMG].blk	MM
Elemental Battle Armor [Laser].blk	MM
Elemental Battle Armor [MG].blk	MM
Elemental Battle Armor [Pulse Laser].blk	MM
Elemental II Battle Armor Production.blk	MM
Elemental II Battle Armor X.blk	MM
Emperor EMP-5A.mtf	MM
Emperor EMP-6A.mtf	MM
Emperor EMP-6D.mtf	MM
Emperor EMP-6L.mtf	MM
Emperor EMP-6M.mtf	MM
Emperor EMP-6M2.mtf	MWL
Emperor EMP-6ME Mercury Elite.mtf	MM
Emperor EMP-6R.mtf	MWL
Emperor EMP-6S.mtf	MM
Emperor EMP-7A.mtf	MWL
Emperor EMP-7AC.mtf	MWL
Emperor EMP-7L.mtf	MM
Emperor EMP-7RK.mtf	MWL
Emperor EMP-8A.mtf	MWL
Emperor EMP-8L.mtf	MM
Emperor Nerran.mtf	MM
Enfield END-6J.mtf	MM
Enfield END-6Q.mtf	MM
Enfield END-6S.mtf	MM
Enfield END-6Sr.mtf	MM
Enfield END-8Q.mtf	MWL
Enforcer ENF-4R Daniel.mtf	MM
Enforcer ENF-4R.mtf	MM
Enforcer ENF-4V.mtf	MWL
Enforcer ENF-5D Daniel.mtf	MM
Enforcer ENF-5D.mtf	MM
Enforcer ENF-5D2.mtf	MWL
Enforcer ENF-5R.mtf	MWL
Enforcer III ENF-6G.mtf	MM
Enforcer III ENF-6H.mtf	MM
Enforcer III ENF-6M.mtf	MM
Enforcer III ENF-6Ma.mtf	MM
Enforcer III ENF-6NAIS.mtf	MM
Enforcer III ENF-6T.mtf	MM
Enforcer III ENF-7C3BS.mtf	MM
Enforcer III ENF-7X MUSE COMPACT.mtf	MM
Enforcer III ENF-8D.mtf	MWL
Engineering Vehicle (Autocannon).blk	MM
Engineering Vehicle (Flamer).blk	MM
Engineering Vehicle.blk	MM
Enyo Strike Tank ER Pulse.blk	MM
Enyo Strike Tank Sholef.blk	MM
Enyo Strike Tank XR.blk	MM
Enyo Strike Tank.blk	MM
Epona Pursuit Tank A.blk	MM
Epona Pursuit Tank B.blk	MM
Epona Pursuit Tank C.blk	MM
Epona Pursuit Tank D.blk	MM
Epona Pursuit Tank E.blk	MM
Epona Pursuit Tank Prime.blk	MM
Erlang Shen.blk	MWL
Error OMG-UR-FD.hmp	MWL
Estevez AA.blk	MM
Estevez MBT.blk	MM
Excalibur Cernunnos.mtf	MM
Excalibur EXC-B1.mtf	MM
Excalibur EXC-B1A.mtf	MWL
Excalibur EXC-B2.mtf	MM
Excalibur EXC-B2b.mtf	MM
Excalibur EXC-C1.mtf	MM
Excalibur EXC-C4.mtf	MWL
Excalibur EXC-CS.mtf	MM
Excalibur EXC-CS2.mtf	MWL
Excalibur EXC-D1.mtf	MM
Excalibur IIC.mtf	MWL
Exhumer EXR-2X.mtf	MM
Exhumer EXR-3P.mtf	MM
Exterminator EXT-4A.mtf	MM
Exterminator EXT-4C.mtf	MM
Exterminator EXT-4D.mtf	MM
Exterminator EXT-4Db.mtf	MM
Exterminator EXT-4DS.mtf	MWL
Exterminator EXT-4DX Caine.mtf	MM
Exterminator EXT-4H.mtf	MWL
Exterminator EXT-5E.mtf	MM
Exterminator EXT-5F.mtf	MM
Exterminator EXT-6CS.mtf	MM
Exterminator EXT-IIC.mtf	MWL
Eyleuka EYL-35A.mtf	MM
Eyleuka EYL-45A.mtf	MM
Eyleuka EYL-45B.mtf	MM
Eyleuka EYL-4A.mtf	MM
Eyrie (Standard).mtf	MM
Fa Shih Battle Armor (Support) [King David].blk	MM
Fa Shih Battle Armor (Support) [Plasma].blk	MM
Fa Shih Battle Armor [Flamer].blk	MM
Fa Shih Battle Armor [Laser].blk	MM
Fa Shih Battle Armor [LRR].blk	MM
Fa Shih Battle Armor [MG].blk	MM
Fa Shih Battle Armor [TAG].blk	MM
Fa Shih Battle Armor 2 [MG].blk	MM
Fafnir FNR-4A Peter.mtf	MM
Fafnir FNR-5.mtf	MM
Fafnir FNR-5B.mtf	MM
Fafnir FNR-5C.mtf	MWL
Fafnir FNR-5WB.mtf	MM
Fafnir FNR-5X.mtf	MM
Fafnir FNR-6R.mtf	MWL
Fafnir FNR-6U.mtf	MM
Fafnir FNR-7S.mtf	MWL
Falcon FLC-4N.mtf	MM
Falcon FLC-4Nb Saho.mtf	MM
Falcon FLC-4Nb.mtf	MM
Falcon FLC-4Nb-PP.mtf	MM
Falcon FLC-4Nb-PP2.mtf	MM
Falcon FLC-4P.mtf	MM
Falcon FLC-5P.mtf	MM
Falcon FLC-6C.mtf	MM
Falcon Hawk FNHK-10K1A.mtf	MWL
Falcon Hawk FNHK-10K1B.mtf	MWL
Falcon Hawk FNHK-9K.mtf	MM
Falcon Hawk FNHK-9K1A.mtf	MM
Falcon Hawk FNHK-9K1B.mtf	MM
Falcon Hover Tank.blk	MM
Falconer FLC-11R.mtf	MWL
Falconer FLC-8R.mtf	MM
Falconer FLC-9R.mtf	MM
Fennec FEC-1CM.mtf	MM
Fennec FEC-3C.mtf	MM
Fennec FEC-5CM.mtf	MM
Fenrir Battle Armor [ERML].blk	MM
Fenrir Battle Armor [MG].blk	MM
Fenrir Battle Armor [Mortar].blk	MM
Fenrir Battle Armor [MPL].blk	MM
Fenrir Battle Armor [SL].blk	MM
Fenrir Battle Armor [SPLAS].blk	MM
Fenrir Battle Armor [SRM].blk	MM
Fenrir Battle Armor [VSP].blk	MM
Fenrir Battle Armor Longshot.blk	MM
Fenrir II Assault Battlearmor (AI).blk	MM
Fenrir II Assault Battlearmor (LRM).blk	MM
Fenrir II Assault Battlearmor (ML).blk	MM
Fenrir II Assault Battlearmor (MRR).blk	MM
Fenrir II Assault Battlearmor (SRM).blk	MM
Fenris (Ice Ferret) A.mtf	MM
Fenris (Ice Ferret) B.mtf	MM
Fenris (Ice Ferret) C.mtf	MM
Fenris (Ice Ferret) D.mtf	MM
Fenris (Ice Ferret) E.mtf	MM
Fenris (Ice Ferret) G.mtf	MWL
Fenris (Ice Ferret) H.mtf	MM
Fenris (Ice Ferret) HW.mtf	MWL
Fenris (Ice Ferret) L.mtf	MM
Fenris (Ice Ferret) Prime.mtf	MM
Fenris (Ice Ferret) U.mtf	MM
Fensalir Combat WiGE (HAG).blk	MM
Fensalir Combat WiGE (Infantry).blk	MM
Fensalir Combat WiGE.blk	MM
Ferret Light Scout VTOL (Armor) Wild Weasel.blk	MM
Ferret Light Scout VTOL (Cargo).blk	MM
Ferret Light Scout VTOL (Fermi).blk	MM
Ferret Light Scout VTOL.blk	MM
Fire Falcon A.mtf	MM
Fire Falcon B.mtf	MM
Fire Falcon C.mtf	MM
Fire Falcon D.mtf	MM
Fire Falcon E.mtf	MM
Fire Falcon F.mtf	MM
Fire Falcon H.mtf	MM
Fire Falcon Prime.mtf	MM
Fire Falcon V.mtf	MWL
Fire Javelin JVN-11N.mtf	MWL
Fire Moth A.mtf*	MWL
Fire Moth B.mtf*	MWL
Fire Moth C.mtf*	MWL
Fire Moth D.mtf*	MWL
Fire Moth E.mtf*	MWL
Fire Moth F.mtf*	MWL
Fire Moth G.mtf*	MWL
Fire Moth H.mtf*	MWL
Fire Moth K.mtf*	MWL
Fire Moth Prime.mtf*	MWL
Fire Scorpion .mtf	MM
Fire Scorpion 2.mtf	MM
Fire Scorpion 3.mtf	MM
Fireball ALM-10D.mtf	MM
Fireball ALM-13D.mtf	MWL
Fireball ALM-7D.mtf	MM
Fireball ALM-8D.mtf	MM
Fireball ALM-9D.mtf	MM
Firebee FRB-1E(WAM-B).mtf	MM
Firebee FRB-2E.mtf	MM
Firebee FRB-3E.mtf	MM
Firefly C.mtf	MM
Firefly FFL-3A.mtf	MM
Firefly FFL-3PP.mtf	MM
Firefly FFL-3PP2.mtf	MM
Firefly FFL-3PP3.mtf	MM
Firefly FFL-3SLE.mtf	MM
Firefly FFL-4A.mtf	MM
Firefly FFL-4B.mtf	MM
Firefly FFL-4C.mtf	MM
Firefly FFL-4D.mtf	MM
Firefly FFL-4DA.mtf	MM
Firestarter FS10-H.mtf	MWL
Firestarter FS10-M.mtf	MWL
Firestarter FS9-A.mtf	MM
Firestarter FS9-B.mtf	MM
Firestarter FS9-C.mtf	MM
Firestarter FS9-H.mtf	MM
Firestarter FS9-K.mtf	MM
Firestarter FS9-M Mirage.mtf	MM
Firestarter FS9-M.mtf	MWL
Firestarter FS9-M2.mtf	MM
Firestarter FS9-M3.mtf	MM
Firestarter FS9-M4.mtf	MM
Firestarter FS9-MW.mtf	MWL
Firestarter FS9-O I.mtf	MWL
Firestarter FS9-O P.mtf	MWL
Firestarter FS9-O.mtf	MM
Firestarter FS9-OA.mtf	MM
Firestarter FS9-OB.mtf	MM
Firestarter FS9-OC.mtf	MM
Firestarter FS9-OD.mtf	MM
Firestarter FS9-OE.mtf	MM
Firestarter FS9-OF.mtf	MM
Firestarter FS9-OG.mtf	MM
Firestarter FS9-OH.mtf	MM
Firestarter FS9-OR.mtf	MM
Firestarter FS9-OU.mtf	MM
Firestarter FS9-OX.mtf	MM
Firestarter FS9-P.mtf	MM
Firestarter FS9-S.mtf	MM
Firestarter FS9-S1.mtf	MM
Firestarter FS9-S2.mtf	MM
Firestarter FS9-S3.mtf	MM
Firestarter FS9-X81.mtf	MM
Flagstaff III.blk	MWL
Flagstaff IV.blk	MWL
Flamberge 2.mtf	MM
Flamberge 3.mtf	MM
Flamberge A.mtf	MM
Flamberge B.mtf	MM
Flamberge C.mtf	MM
Flamberge D.mtf	MM
Flamberge Prime.mtf	MM
Flashfire FLS-P2.mtf	MM
Flashfire FLS-P4.mtf	MM
Flashfire FLS-P5.mtf	MM
Flashman FLS-11SK.mtf	MWL
Flashman FLS-7K.mtf	MM
Flashman FLS-8K.mtf	MM
Flashman FLS-9B.mtf	MM
Flashman FLS-9C.mtf	MM
Flashman FLS-9M.mtf	MM
Flashman FLS-C.mtf	MM
Flashman FLS-IIC.mtf	MWL
Flatbed Truck (Armor).blk	MM
Flatbed Truck (LRM).blk	MM
Flatbed Truck (Mortar).blk	MM
Flatbed Truck (RL).blk	MM
Flatbed Truck (SRM).blk	MM
Flatbed Truck.blk	MM
Flea Fire Ant.mtf	MM
Flea FLE-14.mtf	MM
Flea FLE-15.mtf	MM
Flea FLE-17.mtf	MM
Flea FLE-19.mtf	MM
Flea FLE-20.mtf	MM
Flea FLE-22.mtf	MWL
Flea FLE-4.mtf	MM
Flea FLE-PX.mtf	MWL
Forge FRG-E1.mtf	MWL
Forge FRG-E2.mtf	MWL
Forge FRG-F1.mtf	MWL
Forge FRG-F2.mtf	MWL
Forge FRG-G1.mtf	MWL
Fortune Wheeled Assault Vehicle (C3M).blk	MM
Fortune Wheeled Assault Vehicle [Thunderbolt].blk	MM
Fortune Wheeled Assault Vehicle.blk	MM
Fox Armored Car (Dark Age).blk	MWL
Fox Armored Car (Flamer).blk	MM
Fox Armored Car (Interdictor).blk	MM
Fox Armored Car (VSP).blk	MM
Fox Armored Car.blk	MM
Foxhound (Reynard).blk	MWL
Fulcrum Heavy Hover Tank Hybrid.blk	MM
Fulcrum Heavy Hovertank (X).blk	MWL
Fulcrum Heavy Hovertank II.blk	MM
Fulcrum Heavy Hovertank X.blk	MM
Fulcrum Heavy Hovertank.blk	MM
Fulcrum II Heavy Hovertank.blk	MWL
Fulcrum III Heavy Hovertank.blk	MM
Fury (CS).blk	MWL
Fury (WoB).blk	MWL
Fury Command Tank (C3M).blk	MM
Fury Command Tank (C3S).blk	MM
Fury Command Tank (Fury II).blk	MM
Fury Command Tank (Fury III).blk	MM
Fury Command Tank (Fury IIIm).blk	MM
Fury Command Tank (Original).blk	MM
Fury Command Tank (Royal).blk	MM
Fury Command Tank.blk	MM
Fury CX-17.blk	MM
Fury IIC.blk	MWL
Fusilier BattleArmor (Standard).blk	MM
Fusilier BattleArmor (Upgraded).blk	MM
Fwltur FWL-3R SalvageMech.mtf	MM
Fwltur FWL-3V SalvageMech.mtf	MM
Gabriel Reconnaissance Hovercraft (ERSL).blk	MM
Gabriel Reconnaissance Hovercraft (TDF).blk	MM
Gabriel Reconnaissance Hovercraft.blk	MM
Galahad (Glass Spider) 2.mtf	MM
Galahad (Glass Spider) 3.mtf	MM
Galahad (Glass Spider).mtf	MM
Galahad GLH-1D.mtf	MM
Galahad GLH-2D.mtf	MM
Galahad GLH-3D Laodices.mtf	MM
Galahad GLH-3D.mtf	MM
Galahad GLH-4D.mtf	MWL
Gallant GLT-10-0.mtf	MM
Gallant GLT-7-0.mtf	MM
Gallant GLT-8-0.mtf	MM
Gallant Urban Assault Tank (3067).blk	MWL
Gallant Urban Assault Tank (CGRK).blk	MWL
Gallant Urban Assault Tank.blk	MM
Galleon Light Tank (3050).blk	MWL
Galleon Light Tank (RL).blk	MM
Galleon Light Tank GAL-100.blk	MM
Galleon Light Tank GAL-102.blk	MM
Galleon Light Tank GAL-103.blk	MM
Galleon Light Tank GAL-104.blk	MM
Galleon Light Tank GAL-200 (RL).blk	MWL
Galleon Light Tank GAL-200.blk	MM
Galleon Light Tank GAL-216.blk	MWL
Galleon Light Tank Maxwell.blk	MM
Gallowglas GAL-1GLS.mtf	MM
Gallowglas GAL-2GLS.mtf	MM
Gallowglas GAL-2GLSA.mtf	MM
Gallowglas GAL-3GLS.mtf	MM
Gallowglas GAL-4GLS.mtf	MM
Gallowglas GAL-4GLSA.mtf	MM
Gallowglas GAL-5GLSA.mtf	MWL
Gallowglas GAL-6GLS.mtf	MWL
Gallowglas GAL-7GLS.mtf	MWL
Gallowglas WD.mtf	MM
Gambit GBT-1G.mtf	MM
Gambit GBT-1L.mtf	MM
Garm GRM-01A.mtf	MM
Garm GRM-01A2.mtf	MM
Garm GRM-01B.mtf	MM
Garm GRM-01C.mtf	MM
Garm GRM-01C2.mtf	MWL
Garm GRM-02B.mtf	MWL
Garrot Superheavy Transport.blk	MM
Garuda Heavy VTOL.blk	MM
Gauntlet GTL-1O.mtf	MM
Gauntlet GTL-1OA.mtf	MM
Gauntlet GTL-1OB.mtf	MM
Gauntlet GTL-1OC.mtf	MM
GD Infiltrator Suit (Firedrake).blk	MM
GD Infiltrator Suit (ISensors).blk	MM
GD Infiltrator Suit (Light TAG).blk	MM
GD Infiltrator Suit (Mine).blk	MM
GD Infiltrator Suit (Remote Sensors).blk	MM
Ghora (Standard).blk	MWL
Ghost GST-10.mtf	MM
Ghost GST-11.mtf	MM
Ghost GST-50.mtf	MM
Ghost GST-90.mtf	MM
Giggins APC (Fire Support).blk	MM
Giggins APC.blk	MM
Gladiator (Executioner) A.mtf	MM
Gladiator (Executioner) B.mtf	MM
Gladiator (Executioner) C.mtf	MM
Gladiator (Executioner) D.mtf	MM
Gladiator (Executioner) E.mtf	MM
Gladiator (Executioner) F.mtf	MM
Gladiator (Executioner) G.mtf	MM
Gladiator (Executioner) H.mtf	MM
Gladiator (Executioner) I.mtf	MM
Gladiator (Executioner) K.mtf	MM
Gladiator (Executioner) P.mtf	MM
Gladiator (Executioner) Prime.mtf	MM
Gladiator Exoskeleton (Standard) [AG].blk	MM
Gladiator Exoskeleton (Standard) [BC ID].blk	MM
Gladiator Exoskeleton The Spider.blk	MM
Gladiator GLD-1R.mtf	MM
Gladiator GLD-2R.mtf	MM
Gladiator GLD-3R.mtf	MM
Gladiator GLD-4R.mtf	MM
Gladiator GLD-5R.mtf	MM
Gladiator Keller.mtf	MM
Gladiator-S Exoskeleton.blk	MM
Gladius Medium Hover Tank Mk II.blk	MM
Gladius Medium Hover Tank.blk	MM
Glaive Medium Tank (MFB).blk	MM
Glaive Medium Tank.blk	MM
Glory Heavy Fire Support Vehicle (3090 Upgrade).blk	MM
Glory Heavy Fire Support Vehicle (Light Gauss).blk	MM
Glory Heavy Fire Support Vehicle [Arrow IV].blk	MM
Glory Heavy Fire Support Vehicle.blk	MM
Gnome (Upgrade) Elite.blk	MWL
Gnome (Upgrade-Bearhunter) Elite.blk	MWL
Gnome (Upgrade-Bearhunter).blk	MWL
Gnome (Upgrade-MRR) Elite.blk	MWL
Gnome (Upgrade-Pulse Laser) Elite.blk	MWL
Gnome Battle Armor (LRM) Elite.BLK	MWL
Gnome Battle Armor (LRM).blk	MM
Gnome Battle Armor (Upgrade) [MRR].blk	MM
Gnome Battle Armor (Upgrade) [Pulse Laser].blk	MM
Gnome Battle Armor (Upgrade).blk	MM
Gnome Battle Armor.blk	MM
Gnome Elite.blk	MWL
Goblin II Infantry Support Vehicle.blk	MM
Goblin Infantry Support Vehicle (Sealed).blk	MM
Goblin Infantry Support Vehicle II.blk	MWL
Goblin Infantry Support Vehicle.blk	MM
Goblin Medium Tank (Bugbear).blk	MWL
Goblin Medium Tank (C3M).blk	MWL
Goblin Medium Tank (CS).blk	MWL
Goblin Medium Tank (Extended B).blk	MWL
Goblin Medium Tank (Extended).blk	MWL
Goblin Medium Tank (Hobgoblin).blk	MWL
Goblin Medium Tank (Kurita).blk	MWL
Goblin Medium Tank (LRM).blk	MM
Goblin Medium Tank (MG).blk	MM
Goblin Medium Tank (SRM).blk	MM
Goblin Medium Tank X.blk	MM
Goblin Medium Tank.blk	MM
Golem (Fast Attack) Elite.blk	MWL
Golem (Fast Attack).blk	MWL
Golem Assault Armor (Fast Assault).blk	MM
Golem Assault Armor (Rock Golem).blk	MM
Golem Assault Armor (Support) Elite.BLK	MWL
Golem Assault Armor (Support).blk	MM
Golem Assault Armor.blk	MM
Golem Elite.blk	MWL
Goliath GOL-10S.mtf	MWL
Goliath GOL-1H.mtf	MM
Goliath GOL-2H.mtf	MM
Goliath GOL-3L.mtf	MM
Goliath GOL-3M.mtf	MM
Goliath GOL-3S.mtf	MM
Goliath GOL-4S.mtf	MM
Goliath GOL-5D.mtf	MM
Goliath GOL-5W.mtf	MM
Goliath GOL-6H.mtf	MM
Goliath GOL-6M.mtf	MM
Goliath GOL-7M.mtf	MWL
Goliath GOL-9S.mtf	MWL
Gorilla Exoskeleton PEX-2B.blk	MM
Goshawk (Vapor Eagle) 2.mtf	MM
Goshawk (Vapor Eagle) 3.mtf	MM
Goshawk (Vapor Eagle) 4.mtf	MM
Goshawk (Vapor Eagle).mtf	MM
Goshawk II 2.mtf	MM
Goshawk II 3.mtf	MM
Goshawk II.mtf	MM
Gossamer (XL) VTOL.blk	MM
Gossamer VTOL.blk	MM
Gotha GTHA-100.blk	MWL
Gotha GTHA-300.blk	MWL
Gotha GTHA-500.blk	MWL
Gotha GTHA-500b.blk	MWL
Gotha GTHA-600.blk	MWL
Gotterdammerung GTD-20S.mtf	MM
Gouwu che (Standard).blk	MWL
Grand Crusader GRN-D-01.mtf	MM
Grand Crusader GRN-D-02.mtf	MM
Grand Crusader GRN-D-05.mtf	MWL
Grand Crusader GRN-D-11.mtf	MWL
Grand Crusader GRN-D-12.mtf	MWL
Grand Crusader II GRN-D-03.mtf	MM
Grand Crusader II GRN-D-04.mtf	MM
Grand Crusader II GRN-D-06.mtf	MWL
Grand Dragon DGR-10K.mtf	MWL
Grand Dragon DGR-9K.mtf	MWL
Grand Dragon Douglas.mtf	MM
Grand Dragon DRG-10K.mtf	MM
Grand Dragon DRG-1G Emory.mtf	MM
Grand Dragon DRG-1G.mtf	MM
Grand Dragon DRG-5K Emory.mtf	MM
Grand Dragon DRG-5K.mtf	MM
Grand Dragon DRG-7K Mark.mtf	MM
Grand Dragon DRG-7K.mtf	MM
Grand Dragon DRG-7KC.mtf	MM
Grand Dragon DRG-8K.mtf	MWL
Grand Dragon DRG-9KC.mtf	MM
Grand Dragon DRG-C.mtf	MM
Grand Titan T-IT-N10M.mtf	MM
Grand Titan T-IT-N10MA.mtf	MWL
Grand Titan T-IT-N11M.mtf	MM
Grand Titan T-IT-N11W.mtf	MWL
Grand Titan T-IT-N12M.mtf	MWL
Grand Titan T-IT-N13M.mtf	MM
Grand Titan Vengeance T-IT-N14R.mtf	MM
Grasshopper (Reynolds).mtf	MM
Grasshopper GHR-5H.mtf	MM
Grasshopper GHR-5J.mtf	MM
Grasshopper GHR-5N.mtf	MM
Grasshopper GHR-5R.mtf	MWL
Grasshopper GHR-6K.mtf	MM
Grasshopper GHR-7K Gravedigger.mtf	MM
Grasshopper GHR-7K.mtf	MM
Grasshopper GHR-7P.mtf	MM
Grasshopper GHR-7X.mtf	MM
Grasshopper GHR-9K.mtf	MWL
Grasshopper GHR-C.mtf	MM
Gravedigger GDR-1C.mtf	MM
Gravedigger GDR-1D.mtf	MM
Gray Death Heavy Suit (Varangian).BLK	MWL
Gray Death Heavy Suit.blk	MM
Gray Death Scout Suit The Willow Wisps.blk	MM
Gray Death Scout Suit.blk	MM
Gray Death Standard (Magshot).blk	MWL
Gray Death Standard (Varangian).blk	MWL
Gray Death Standard Suit [Flamer].blk	MM
Gray Death Standard Suit [Laser].blk	MM
Gray Death Standard Suit [LRR].blk	MM
Gray Death Standard Suit [MG].blk	MM
Gray Death Standard Suit [SRM].blk	MM
Gray Death Strike Armor (Harjel).blk	MM
Gray Death Strike Armor Production.blk	MM
Gray Death Strike Armor Prototype.blk	MM
Great Turtle GTR-1.mtf	MM
Great Turtle GTR-2.mtf	MM
Great Wyrm .mtf	MM
Great Wyrm 2.mtf	MM
Great Wyrm Aemelia.mtf	MM
Grenadier Battle Armor (Hunter-Killer) [MagShot].blk	MM
Grenadier Battle Armor (Hunter-Killer) [NARC].blk	MM
Grenadier Battle Armor [Flamer].blk	MM
Grenadier Battle Armor [Heavy Flamer].blk	MM
Grenadier Battle Armor [Hunter-Killer C3 HRR].blk	MM
Grenadier Battle Armor [Hunter-Killer SVSP MAgshot].blk	MM
Grenadier Battle Armor [LRR].blk	MM
Grenadier Battle Armor [MagShot].blk	MM
Grenadier Battle Armor [SL].blk	MM
Grenadier Battle Armor [TAG].blk	MM
Grendel (Mongrel) A.mtf	MM
Grendel (Mongrel) B.mtf	MM
Grendel (Mongrel) C.mtf	MM
Grendel (Mongrel) D.mtf	MM
Grendel (Mongrel) E.mtf	MM
Grendel (Mongrel) F.mtf	MM
Grendel (Mongrel) H.mtf	MM
Grendel (Mongrel) Prime.mtf	MM
Grendel (Mongrel) S.mtf	MWL
Griffin GRF-1DS.mtf	MM
Griffin GRF-1E Sparky.mtf	MM
Griffin GRF-1E2 Sparky 2.0.mtf	MM
Griffin GRF-1N.mtf	MM
Griffin GRF-1P.mtf	MWL
Griffin GRF-1S.mtf	MM
Griffin GRF-2N.mtf	MM
Griffin GRF-3L.mtf	MWL
Griffin GRF-3LA.mtf	MWL
Griffin GRF-3M.mtf	MM
Griffin GRF-3TC.mtf	MWL
Griffin GRF-3W.mtf	MWL
Griffin GRF-4N.mtf	MM
Griffin GRF-4R.mtf	MM
Griffin GRF-5K.mtf	MM
Griffin GRF-5L.mtf	MM
Griffin GRF-5M.mtf	MM
Griffin GRF-5S.mtf	MWL
Griffin GRF-6CS.mtf	MM
Griffin GRF-6S Francine II.mtf	MM
Griffin GRF-6S Francine.mtf	MM
Griffin GRF-6S.mtf	MM
Griffin GRF-6S2.mtf	MM
Griffin GRF-7CS.mtf	MWL
Griffin GRF-7M.mtf	MWL
Griffin GRF-8M.mtf	MWL
Griffin GRF-9K.mtf	MWL
Griffin GRF-9S.mtf	MWL
Griffin IIC .mtf	MM
Griffin IIC 2.mtf	MM
Griffin IIC 3.mtf	MM
Griffin IIC 4.mtf	MM
Griffin IIC 5.mtf	MM
Griffin IIC 6.mtf	MM
Griffin IIC 7.mtf	MM
Griffin IIC 8.mtf	MM
Grigori C-GRG-O Asmodaeus.mtf	MWL
Grigori C-GRG-O Caelestis.mtf	MWL
Grigori C-GRG-O Comminus.mtf	MWL
Grigori C-GRG-O Dominus.mtf	MWL
Grigori C-GRG-O Eminus.mtf	MWL
Grigori C-GRG-O Infernus V.mtf	MWL
Grigori C-GRG-O Infernus.mtf	MWL
Grigori C-GRG-O Invictus.mtf	MM
Grigori C-GRG-O Invictus.mtf	MWL
Grigori C-GRG-O Luminos.mtf	MWL
Grigori C-GRG-O Rufus.mtf	MM
Grigori C-GRG-O Tamiel.mtf	MM
Grigori C-GRG-OA Dominus.mtf	MM
Grigori C-GRG-OB Infernus.mtf	MM
Grigori C-GRG-OC Comminus.mtf	MM
Grigori C-GRG-OD Luminos.mtf	MM
Grigori C-GRG-OE Eminus.mtf	MM
Grigori C-GRG-OS Caelestis.mtf	MM
Grigori C-GRG-OU Exanimus.mtf	MM
Grim Reaper GRM-R (Einar).mtf	MM
Grim Reaper GRM-R-PR29.mtf	MM
Grim Reaper GRM-R-PR30.mtf	MM
Grim Reaper GRM-R-PR31.mtf	MM
Grim Reaper GRM-R-PR32V.mtf	MWL
Grim Reaper GRM-R-PR33A.mtf	MWL
Grim Reaper GRM-R-PR62A.mtf	MM
Grizzly .mtf	MM
Grizzly 2.mtf	MM
Grizzly 4.mtf	MWL
Grizzly 5.mtf	MWL
Ground Car.blk	MM
Groundhog Exoskeleton CEX-205.blk	MM
Guerteltier MBT (C3M).blk	MM
Guerteltier MBT.blk	MM
Guillotine GLT-3CS.mtf	MWL
Guillotine GLT-3N.mtf	MM
Guillotine GLT-4L.mtf	MM
Guillotine GLT-4P.mtf	MM
Guillotine GLT-5M.mtf	MM
Guillotine GLT-5P.mtf	MWL
Guillotine GLT-5TC.mtf	MWL
Guillotine GLT-6CS.mtf	MWL
Guillotine GLT-6WB.mtf	MM
Guillotine GLT-6WB2.mtf	MM
Guillotine GLT-6WB3.mtf	MM
Guillotine GLT-7M.mtf	MWL
Guillotine GLT-7ME.mtf	MWL
Guillotine GLT-8D.mtf	MM
Guillotine GLT-8M.mtf	MWL
Guillotine GLT-9CS.mtf	MWL
Guillotine IIC .mtf	MM
Guillotine IIC 2.mtf	MM
Gulltoppr OmniMonitor (A).blk	MM
Gulltoppr OmniMonitor (B).blk	MM
Gulltoppr OmniMonitor (Prime).blk	MM
Gun GN-2O.mtf	MM
Gun GN-2OA.mtf	MM
Gun GN-2OC.mtf	MM
Gun Trailer (Ambush).blk	MM
Gun Trailer (Artillery AAA).blk	MM
Gun Trailer (LRM).blk	MM
Gun Trailer (Mjolnir).blk	MM
Gun Trailer (Siege).blk	MM
Gun Trailer (Sniper Cannon).blk	MM
Gun Trailer (Stronghold).blk	MM
Gun Trailer (Thumper).blk	MM
Gun Trailer (Thunderbolt).blk	MM
Gun Trailer (Ultra).blk	MM
Gunslinger GUN-1ERD.mtf	MM
Gunslinger GUN-2ERD.mtf	MM
Gunslinger GUN-2ERDr.mtf	MM
Gunslinger GUN-3ERD.mtf	MWL
Gunslinger GUN-4ERD.mtf	MWL
Gunslinger GUN-5ERD.mtf	MWL
Gunslinger GUN-8ERD.mtf	MWL
Gunslinger Jared.mtf	MM
Gunsmith CH11-NG.mtf	MM
Gurkha GUR-2G.mtf	MM
Gurkha GUR-3G.mtf	MWL
Gurkha GUR-4G.mtf	MM
Gurkha GUR-6G.mtf	MM
Gurkha GUR-8G.mtf	MM
Gurzil Support Tank (Standard).blk	MM
Gyrfalcon (Standard).mtf	MM
Gyrfalcon 2.mtf	MM
Gyrfalcon 3.mtf	MM
Gyrfalcon 4.mtf	MM
Gyrfalcon Gunship VTOL (Standard).blk	MWL
Ha Otoko .mtf	MM
Ha Otoko 2.mtf	MM
Ha Otoko 3.mtf	MM
Ha Otoko HKO-1C.mtf	MM
Ha Otoko HKO-1CA.mtf	MWL
Ha Otoko-HR.mtf	MM
Hachiman Fire Support Tank (AAA).blk	MM
Hachiman Fire Support Tank (Standard).blk	MM
Hachiwara HCA-3T.mtf	MM
Hachiwara HCA-4T.mtf	MM
Hachiwara HCA-4U.mtf	MM
Hachiwara HCA-6P.mtf	MM
Hadur Fast Support Vehicle (Standard).blk	MM
Hammer HMR-3C.mtf	MM
Hammer HMR-3M.mtf	MM
Hammer HMR-3P.mtf	MM
Hammer HMR-3S.mtf	MM
Hammer HMR-5P.mtf	MWL
Hammerhands HMH-3D Kessem.mtf	MM
Hammerhands HMH-3D.mtf	MM
Hammerhands HMH-4D.mtf	MM
Hammerhands HMH-4D2.mtf	MWL
Hammerhands HMH-4D3.mtf	MWL
Hammerhands HMH-5D.mtf	MM
Hammerhands HMH-6D.mtf	MM
Hammerhands HMH-6E.mtf	MM
Hammerhead HMR-HD.blk	MWL
Hammerhead HMR-HDb.blk	MWL
Hammerhead HMR-HE.blk	MWL
Hammerhead HMR-HF.blk	MWL
Hammerhead HMR-HG.blk	MWL
Hammerhead II (Economy).blk	MWL
Hammerhead II .blk	MWL
Hankyu (Arctic Cheetah) A.mtf	MM
Hankyu (Arctic Cheetah) B.mtf	MM
Hankyu (Arctic Cheetah) C.mtf	MM
Hankyu (Arctic Cheetah) D.mtf	MM
Hankyu (Arctic Cheetah) E.mtf	MM
Hankyu (Arctic Cheetah) F.mtf	MM
Hankyu (Arctic Cheetah) H.mtf	MM
Hankyu (Arctic Cheetah) Prime.mtf	MM
Hankyu Q.mtf	MWL
Hanse MBT (Standard).blk	MM
Harasser Laser Platform.blk	MM
Harasser Missile Platform (Flamer).blk	MM
Harasser Missile Platform (LRM).blk	MM
Harasser Missile Platform (Medium Laser).blk	MWL
Harasser Missile Platform (Mini-Peggy).blk	MM
Harasser Missile Platform (MML).blk	MM
Harasser Missile Platform (Thunderbolt).blk	MM
Harasser Missile Platform Leaping Lisa.blk	MM
Harasser Missile Platform.blk	MM
Harbinger (NOTAR).blk	MWL
Harbinger Armored Fist (NOTAR).blk	MWL
Harpy Attack VTOL (Standard).blk	MWL
Harvester Agromech HVR-99.mtf	MM
Harvester Ant Agromech KIC-3.mtf	MM
Harvester Ant KIC-3 (LRM).mtf	MM
Harvester Ant KIC-3 (MG).mtf	MM
Hasek Mechanized Combat Vehicle (Standard).blk	MM
Hatamoto HTM-31X.mtf	MWL
Hatamoto-Chi HTM-26T.mtf	MM
Hatamoto-Chi HTM-27T Daniel II.mtf	MM
Hatamoto-Chi HTM-27T Daniel.mtf	MM
Hatamoto-Chi HTM-27T.mtf	MM
Hatamoto-Chi HTM-28T (Shin).mtf	MM
Hatamoto-Chi HTM-28T.mtf	MM
Hatamoto-Chi HTM-28Tr.mtf	MM
Hatamoto-Chi HTM-30T.mtf	MWL
Hatamoto-Chi HTM-37T.mtf	MWL
Hatamoto-Godai HTM-30Z.mtf	MM
Hatamoto-Hi HTM-27U.mtf	MM
Hatamoto-Hi HTM-C.mtf	MM
Hatamoto-Hi HTM-CM.mtf	MM
Hatamoto-Kaeru HTM-35K.mtf	MM
Hatamoto-Kaeru HTM-35X.mtf	MM
Hatamoto-Kaze HTM-27V.mtf	MM
Hatamoto-Ku HTM-27W.mtf	MM
Hatamoto-Mizo HTM-27Y.mtf	MM
Hatamoto-Suna HTM-30S.mtf	MM
Hatchetman HCT-3F Austin.mtf	MM
Hatchetman HCT-3F.mtf	MM
Hatchetman HCT-3TDF.mtf	MWL
Hatchetman HCT-3X.mtf	MWL
Hatchetman HCT-5D.mtf	MM
Hatchetman HCT-5DD.mtf	MM
Hatchetman HCT-5K.mtf	MM
Hatchetman HCT-5S Austin.mtf	MM
Hatchetman HCT-5S.mtf	MM
Hatchetman HCT-5TC.mtf	MWL
Hatchetman HCT-6D.mtf	MM
Hatchetman HCT-6M.mtf	MM
Hatchetman HCT-6RK.mtf	MWL
Hatchetman HCT-6S.mtf	MM
Hatchetman HCT-7A.mtf	MWL
Hatchetman HCT-7D.mtf	MWL
Hatchetman HCT-7S.mtf	MM
Hatchetman HCT-8S.mtf	MWL
Hauberk Battle Armor Commando.blk	MM
Hauberk Battle Armor U15.blk	MM
Hauberk Battle Armor.blk	MM
Hauberk II Battle Armor.blk	MM
Hauptmann HA1-O S.mtf	MWL
Hauptmann HA1-O.mtf	MM
Hauptmann HA1-OA.mtf	MM
Hauptmann HA1-OB.mtf	MM
Hauptmann HA1-OC.mtf	MM
Hauptmann HA1-OD.mtf	MM
Hauptmann HA1-OE.mtf	MM
Hauptmann HA1-OF.mtf	MM
Hauptmann HA1-OI.mtf	MWL
Hauptmann HA1-OM.mtf	MM
Hauptmann HA1-ON.mtf	MWL
Hauptmann HA1-OT.mtf	MM
Havoc HVC-P6.mtf	MM
Hawk Moth Gunship (Armor).blk	MM
Hawk Moth Gunship (Thunderbolt).blk	MM
Hawk Moth Gunship.blk	MM
Hawk Moth II Gunship (MML).blk	MM
Hawk Moth II Gunship (Sniper).blk	MM
Hawk Moth II Gunship (Standard).blk	MM
HawkWolf HWK-3F.mtf	MM
HawkWolf HWK-4F.mtf	MM
Heavy BattleMech Recovery Vehicle.blk	MM
Heavy Hover APC (Comstar) MWL.blk	MWL
Heavy Hover APC (LRM).blk	MM
Heavy Hover APC (MG).blk	MM
Heavy Hover APC (Scout Tank).blk	MM
Heavy Hover APC (SRM).blk	MM
Heavy Hover APC MWL.blk	MWL
Heavy Hover APC.blk	MM
Heavy LRM Carrier (ELRM).blk	MWL
Heavy LRM Carrier (EN Variant).blk	MM
Heavy LRM Carrier.blk	MM
Heavy MML Carrier.blk	MM
Heavy NLRM Carrier.blk	MM
Heavy Tracked APC (Comstar) MWL.blk	MWL
Heavy Tracked APC (LRM).blk	MM
Heavy Tracked APC (MG).blk	MM
Heavy Tracked APC (SRM).blk	MM
Heavy Tracked APC MWL.blk	MWL
Heavy Tracked APC.blk	MM
Heavy Transport B1.blk	MM
Heavy Weapons Carrier (PPC).blk	MM
Heavy Wheeled APC (Comstar) MWL.blk	MWL
Heavy Wheeled APC (LRM).blk	MM
Heavy Wheeled APC (MG).blk	MM
Heavy Wheeled APC (SRM).blk	MM
Heavy Wheeled APC (WoB).blk	MM
Heavy Wheeled APC MWL.blk	MWL
Heavy Wheeled APC.blk	MM
HeavyHauler Exoskeleton (Standard).blk	MM
Hector HOR-1B.mtf	MM
Hector HOR-1C.mtf	MM
Heimdall Ground Monitor Tank A.blk	MM
Heimdall Ground Monitor Tank B.blk	MM
Heimdall Ground Monitor Tank C.blk	MM
Heimdall Ground Monitor Tank D.blk	MM
Heimdall Ground Monitor Tank Prime.blk	MM
Heirax Transport.blk	MWL
Heirax XTR.blk	MWL
Heirax ZMM.blk	MWL
Helepolis HEP-1H.mtf	MM
Helepolis HEP-2H.mtf	MM
Helepolis HEP-3H.mtf	MM
Helepolis HEP-4H.mtf	MM
Helios HEL-3D.mtf	MM
Helios HEL-3DR.mtf	MWL
Helios HEL-4A.mtf	MM
Helios HEL-4C.mtf	MWL
Helios HEL-4F.mtf	MWL
Helios HEL-5W.mtf	MWL
Helios HEL-6X.mtf	MM
Helios HEL-C.mtf	MM
Hellcat HCT-213.blk	MWL
Hellcat HCT-213D.blk	MWL
Hellcat HCT-213R.blk	MWL
Hellcat HCT-21D.blk	MWL
Hellcat II HCT-213C.blk	MWL
HellcatII HCT212.blk	MWL
HellcatII HCT213B.blk	MWL
HellcatII HCT214.blk	MWL
HellcatII HCT215.blk	MWL
Hellfire 2.mtf	MM
Hellfire 3.mtf	MM
Hellfire I.mtf	MWL
Hellfire.mtf	MM
Hellhound (Conjurer) 2.mtf	MM
Hellhound (Conjurer) 3.mtf	MM
Hellhound (Conjurer) 4.mtf	MM
Hellhound (Conjurer) 5.mtf	MM
Hellhound (Conjurer).mtf	MM
Hellion A.mtf	MM
Hellion B.mtf	MM
Hellion C.mtf	MM
Hellion D.mtf	MM
Hellion E.mtf	MM
Hellion F.mtf	MM
Hellion G.mtf	MM
Hellion Prime.mtf	MM
Hellion Q.mtf	MWL
Hellspawn HSN-10G.mtf	MM
Hellspawn HSN-10SR.mtf	MM
Hellspawn HSN-11F.mtf	MWL
Hellspawn HSN-7D.mtf	MM
Hellspawn HSN-7D2 Halperin.mtf	MM
Hellspawn HSN-7T.mtf	MWL
Hellspawn HSN-8E.mtf	MM
Hellspawn HSN-9F.mtf	MM
Hellstar 2.mtf	MM
Hellstar 3.mtf	MM
Hellstar.mtf	MM
Hephaestus (AP) Jump Tank.blk	MM
Hephaestus Jump Tank.blk	MM
Hephaestus Scout Tank A.blk	MM
Hephaestus Scout Tank B.blk	MM
Hephaestus Scout Tank C.blk	MM
Hephaestus Scout Tank D.blk	MM
Hephaestus Scout Tank Prime.blk	MM
Hercules HRC-LS-9000.mtf	MM
Hercules HRC-LS-9001.mtf	MM
Hercules HRC-LS-9003.mtf	MWL
Hercules HRC-LS-9004.mtf	MWL
Hercules HRC-LS-9009.mtf	MWL
Hercules Julius.mtf	MM
Hermes HER-1A.mtf	MM
Hermes HER-1B.mtf	MM
Hermes HER-1S.mtf	MM
Hermes HER-1Sb.mtf	MM
Hermes HER-3S.mtf	MM
Hermes HER-3S1.mtf	MM
Hermes HER-3S2.mtf	MM
Hermes HER-4K.mtf	MM
Hermes HER-4M.mtf	MM
Hermes HER-4S.mtf	MM
Hermes HER-4SB.mtf	MWL
Hermes HER-4WB.mtf	MM
Hermes HER-4WS.mtf	MWL
Hermes II HER-2M Mercury.mtf	MM
Hermes II HER-2S.mtf	MM
Hermes II HER-4K Hermes III.mtf	MM
Hermes II HER-5C.mtf	MM
Hermes II HER-5ME.mtf	MM
Hermes II HER-5PP.mtf	MWL
Hermes II HER-5S.mtf	MM
Hermes II HER-5SA.mtf	MM
Hermes II HER-5Sr.mtf	MM
Hermes II HER-6D.mtf	MM
Hermes II HER-6M.mtf	MWL
Hermes II HER-6S.mtf	MWL
Hermes II HER-7S.mtf	MM
Hermes II HER-9M (1).mtf	MWL
Hermes II HER-9M.mtf	MWL
Hermes IIC.mtf	MWL
Hermes III HER-4K.mtf	MWL
Hessian (Infantry).blk	MWL
Hessian (Scout).blk	MWL
Hessian.blk	MWL
Hetzer Wheeled Assault Gun (AC10).blk	MM
Hetzer Wheeled Assault Gun (Clan GB).blk	MWL
Hetzer Wheeled Assault Gun (Jadgpanzer II).blk	MM
Hetzer Wheeled Assault Gun (Laser).blk	MM
Hetzer Wheeled Assault Gun (LB-X).blk	MM
Hetzer Wheeled Assault Gun (LBX).blk	MWL
Hetzer Wheeled Assault Gun (LRM).blk	MM
Hetzer Wheeled Assault Gun (Scout).blk	MM
Hetzer Wheeled Assault Gun (Sealed).blk	MM
Hetzer Wheeled Assault Gun (SRM).blk	MM
Hetzer Wheeled Assault Gun.blk	MM
Highlander HGN-641-X-2.mtf	MM
Highlander HGN-694.mtf	MM
Highlander HGN-732 Colleen.mtf	MM
Highlander HGN-732.mtf	MM
Highlander HGN-732b.mtf	MM
Highlander HGN-733.mtf	MM
Highlander HGN-733C.mtf	MM
Highlander HGN-733P.mtf	MM
Highlander HGN-734.mtf	MM
Highlander HGN-734-R.mtf	MWL
Highlander HGN-736.mtf	MM
Highlander HGN-738.mtf	MM
Highlander HGN-739A.mtf	MWL
Highlander HGN-742.mtf	MWL
Highlander HGN-743A.mtf	MWL
Highlander IIC .mtf	MM
Highlander IIC 2.mtf	MM
Highlander IIC 3.mtf	MM
Highlander IIC 4.mtf	MWL
Hipparch Cavalry Tank.blk	MM
Hiryo Armored Infantry Transport (Light PPC).blk	MWL
Hiryo Armored Infantry Transport (LPPC).blk	MM
Hiryo Armored Infantry Transport (MRM).blk	MM
Hiryo Armored Infantry Transport BloodHound.blk	MM
Hiryo Armored Infantry Transport Hound.blk	MM
Hiryo Armored Infantry Transport.blk	MM
Hi-Scout Drone (NapFind).blk	MM
Hi-Scout Drone (PathTrak).blk	MM
Hi-Scout Drone Carrier.blk	MM
Hitman HM-1.mtf	MM
Hitman HM-1K.mtf	MWL
Hitman HM-1r.mtf	MM
Hitman HM-2.mtf	MM
Hitotsume Kozo HKZ-1F.mtf	MM
Hitotsume Kozo HKZ-1P.mtf	MM
Hollander BZK-F3.mtf	MM
Hollander BZK-F3A.mtf	MWL
Hollander BZK-FL5.mtf	MWL
Hollander BZK-G1.mtf	MM
Hollander II BZK-F11.mtf	MWL
Hollander II BZK-F5.mtf	MM
Hollander II BZK-F7.mtf	MM
Hollander II v9 BZK-F9.mtf	MWL
Hollander III BZK-D1.mtf	MM
Hollander III BZK-D2.mtf	MM
Hollander III BZK-D3.mtf	MM
Hoplite C.mtf	MM
Hoplite C2.mtf	MWL
Hoplite HOP-4B.mtf	MM
Hoplite HOP-4Bb.mtf	MM
Hoplite HOP-4C.mtf	MM
Hoplite HOP-4Cb.mtf	MM
Hoplite HOP-4CS.mtf	MWL
Hoplite HOP-4D.mtf	MM
Hoplite HOP-4X.mtf	MM
Hoplite HOP-5CS.mtf	MWL
Horned Demon.blk	MWL
Horned Owl 6.mtf	MWL
Hornet HNT-151.mtf	MM
Hornet HNT-152.mtf	MM
Hornet HNT-161.mtf	MM
Hornet HNT-171.mtf	MM
Hornet HNT-172A.mtf	MWL
Hornet HNT-181.mtf	MWL
Hound HD-2F.mtf	MM
Hover Scout.blk	MM
Hover Tank.blk	MM
Huitzilopochtli Assault Tank (AAA).blk	MWL
Huitzilopochtli Assault Tank 'Huey' (AAA).blk	MM
Huitzilopochtli Assault Tank 'Huey'.blk	MM
Huitzilopochtli Assault Tank.blk	MWL
Humming Bird Rescue VTOL.blk	MM
Hunchback HBK-4G Hohiro.mtf	MM
Hunchback HBK-4G Shakir.mtf	MM
Hunchback HBK-4G.mtf	MM
Hunchback HBK-4H.mtf	MM
Hunchback HBK-4J.mtf	MM
Hunchback HBK-4N.mtf	MM
Hunchback HBK-4P.mtf	MM
Hunchback HBK-4SP.mtf	MM
Hunchback HBK-5G.mtf	MWL
Hunchback HBK-5H.mtf	MM
Hunchback HBK-5J.mtf	MWL
Hunchback HBK-5KA.mtf	MWL
Hunchback HBK-5M.mtf	MM
Hunchback HBK-5M2.mtf	MWL
Hunchback HBK-5N.mtf	MM
Hunchback HBK-5P.mtf	MM
Hunchback HBK-5PP.mtf	MWL
Hunchback HBK-5RK.mtf	MWL
Hunchback HBK-5S.mtf	MM
Hunchback HBK-5SG.mtf	MM
Hunchback HBK-5SP.mtf	MWL
Hunchback HBK-5SS.mtf	MM
Hunchback HBK-5T.mtf	MWL
Hunchback HBK-6K.mtf	MWL
Hunchback HBK-6L.mtf	MWL
Hunchback HBK-6N.mtf	MM
Hunchback HBK-6S.mtf	MM
Hunchback HBK-6SS.mtf	MWL
Hunchback HBK-7M.mtf	MWL
Hunchback HBK-7R.mtf	MM
Hunchback HBK-7S.mtf	MWL
Hunchback HBK-7X-4.mtf	MM
Hunchback IIC .mtf	MM
Hunchback IIC 2.mtf	MM
Hunchback IIC 3.mtf	MM
Hunchback IIC 4.mtf	MM
Hunchback IIC R.mtf	MWL
Hunter Light Support Tank (3054 Upgrade).blk	MM
Hunter Light Support Tank (Ammo).blk	MM
Hunter Light Support Tank (Amphibious).blk	MM
Hunter Light Support Tank (Assault).blk	MWL
Hunter Light Support Tank (ELRM).blk	MWL
Hunter Light Support Tank (ERLL).blk	MM
Hunter Light Support Tank (GBD).blk	MWL
Hunter Light Support Tank (LPL).blk	MM
Hunter Light Support Tank (LRM10).blk	MM
Hunter Light Support Tank (LRM15).blk	MM
Hunter Light Support Tank (NLRM).blk	MWL
Hunter Light Support Tank (TB).blk	MWL
Hunter Light Support Tank Assault Hunter.blk	MM
Hunter Light Support Tank.blk	MM
Huntsman.mtf	MWL
Huron Warrior HUR-WO-R4L.mtf	MM
Huron Warrior HUR-WO-R4M.mtf	MM
Huron Warrior HUR-WO-R4N.mtf	MM
Huron Warrior HUR-WO-R4O.mtf	MM
Huron Warrior HUR-WO-R4TA.mtf	MWL
Huron Warrior HUR-WO-R5O.mtf	MWL
Hurricane PA (L) P17.blk	MM
Huscarl HSCL-1-O.blk	MWL
Huscarl HSCL-1-OA.blk	MWL
Huscarl HSCL-1-OB.blk	MWL
Huscarl HSCL-1-OC.blk	MWL
Huskey (Standard).blk	MWL
Hussar HSR-200-D.mtf	MM
Hussar HSR-200-Db.mtf	MM
Hussar HSR-300-D.mtf	MM
Hussar HSR-350-D.mtf	MM
Hussar HSR-400-D.mtf	MM
Hussar HSR-500-D.mtf	MM
Hussar HSR-500-DP.mtf	MWL
Hussar HSR-500-DR.mtf	MWL
Hussar HSR-900-D.mtf	MM
Hussar HSR-950-D.mtf	MM
Hussar HSR-IIC.mtf	MWL
HW1 Hwacha.blk	MM
Hydaspes 2.blk	MWL
Hydaspes.blk	MWL
Hyena SalvageMech HYN-4A.mtf	MM
Icarus ICR-1X.mtf	MM
Icarus II ICR-1S.mtf	MM
Icarus II ICR-2S.mtf	MM
Icestorm .mtf	MM
Icestorm 2.mtf	MM
Ignis (SRM).blk	MWL
Ignis Infantry Support Tank (SRM).blk	MM
Ignis Infantry Support Tank.blk	MM
Ignis.blk	MWL
Imp C.mtf	MM
Imp IMP-1A.mtf	MM
Imp IMP-1B.mtf	MM
Imp IMP-1C.mtf	MM
Imp IMP-2E.mtf	MM
Imp IMP-3E.mtf	MM
Imp IMP-4E Turtleback.mtf	MWL
Imp IMP-4E.mtf	MM
Imp IMP-4P.mtf	MWL
Imp IMP-4X.mtf	MWL
Imp IMP-5E.mtf	MWL
Incubus II.mtf	MM
Indra Infantry Transport (BA).blk	MM
Indra Infantry Transport.blk	MM
Infiltrator Mk II Battle Armor (Magnetic).blk	MM
Infiltrator Mk. I Battle Armor (Special Ops).blk	MM
Infiltrator Mk. I Battle Armor.blk	MM
Infiltrator Mk. II Battle Armor (Marine).blk	MM
Infiltrator Mk. II Battle Armor (Sensor).blk	MM
Infiltrator Mk. II Battle Armor Coral Intent.blk	MM
Infiltrator Mk. II Battle Armor.blk	MM
Initiate INI-02.mtf	MM
Initiate INI-04.mtf	MM
Initiate INI-05.mtf	MWL
Ironhold Assault Battle Armor (Anti-Tank).blk	MM
Ironhold Assault Battle Armor (Fire) Elite.blk	MWL
Ironhold Assault Battle Armor (Fire).blk	MM
Ironhold Assault Battle Armor Elite.blk	MWL
Ironhold Assault Battle Armor.blk	MM
Ironsides IRN-SD1.blk	MWL
Ironsides IRN-SD1b.blk	MWL
Ironsides IRN-SD2.blk	MWL
Ironsides IRN-SD3.blk	MWL
IS Standard Battle Armor (Level I) [Flamer].blk	MM
IS Standard Battle Armor (Level I) [Laser].blk	MM
IS Standard Battle Armor (Level I) [LRR].blk	MM
IS Standard Battle Armor (Level I) [MG].blk	MM
IS Standard Battle Armor (Level I) [SRM].blk	MM
IS Standard Battle Armor [Flamer].blk	MM
IS Standard Battle Armor [Hive].blk	MM
IS Standard Battle Armor [Laser].blk	MM
IS Standard Battle Armor [LRR].blk	MM
IS Standard Battle Armor [MG].blk	MM
IS Standard Battle Armor [SRM].blk	MM
Ishtar Heavy Fire Support Tank (Gauss).blk	MM
Ishtar Heavy Fire Support Tank (Original).blk	MM
Ishtar Heavy Fire Support Tank.blk	MM
Isometrus ISO-M3.mtf	MWL
Isometrus ISO-M4.mtf	MWL
Issus 2.blk	MWL
Issus 4.blk	MWL
Issus 5.blk	MWL
Issus 6.blk	MWL
Issus.blk	MWL
Iveco Burro II SuperHeavy Cargo Truck.blk	MM
J. Edgar Light Hover Tank (Cell).blk	MM
J. Edgar Light Hover Tank (Flamer).blk	MM
J. Edgar Light Hover Tank (ICE).blk	MM
J. Edgar Light Hover Tank (Kurita RS).blk	MWL
J. Edgar Light Hover Tank (Kurita).blk	MM
J. Edgar Light Hover Tank (MG).blk	MM
J. Edgar Light Hover Tank (TAG RS).blk	MWL
J. Edgar Light Hover Tank (TAG).blk	MM
J. Edgar Light Hover Tank.blk	MM
J-27 Ordnance Transport (Armor).blk	MM
J-27 Ordnance Transport (Fusion).blk	MM
J-27 Ordnance Transport (Trailer).blk	MM
J-27 Ordnance Transport.blk	MM
J-37 Ordnance Transport (Original).blk	MM
J-37 Ordnance Transport.blk	MM
Jabberwocky ConstructionMech JAW-66D.mtf	MM
Jabberwocky DemolitionMech JAW-66C.mtf	MM
Jabberwocky EngineerMech JAW-66B.mtf	MM
Jackal JA-KL-1532.mtf	MM
Jackal JA-KL-1579.mtf	MM
Jackal JA-KL-55.mtf	MM
Jackal JA-KL-65.mtf	MWL
Jackalope JLP-BD.mtf	MM
Jackalope JLP-C.mtf	MM
Jackalope JLP-KA Wolpertinger.mtf	MM
Jackalope JLP-KA.mtf	MM
Jackrabbit JKR-8T.mtf	MM
Jackrabbit JKR-9R.mtf	MM
Jackrabbit JKR-9W.mtf	MM
Jade Hawk (Standard).mtf	MM
Jade Hawk 2.mtf	MM
Jade Hawk 3.mtf	MM
Jade Hawk JHK-03.mtf	MM
Jade Hawk JHK-04.mtf	MM
Jadgpanzer II .blk	MWL
Jagatai A.blk	MWL
Jagatai B.blk	MWL
Jagatai C.blk	MWL
Jagatai D.blk	MWL
Jagatai F MWL.blk	MWL
Jagatai J.blk	MWL
Jagatai Prime.blk	MWL
Jagatai W.blk	MWL
JagerMech III JM6-D3.mtf	MM
JagerMech III JM6-D4.mtf	MM
JagerMech III JM6-D9.mtf	MWL
JagerMech JM6-A.mtf	MM
Jagermech JM6-AP.mtf	MWL
JagerMech JM6-DD.mtf	MM
JagerMech JM6-DD3.mtf	MWL
JagerMech JM6-DDa.mtf	MM
Jagermech JM6-DG.mtf	MM
JagerMech JM6-DG.mtf	MWL
JagerMech JM6-DGr.mtf	MM
JagerMech JM6-DLA.mtf	MWL
JagerMech JM6-H.mtf	MM
JagerMech JM6-S.mtf	MM
JagerMech JM7-C3BS.mtf	MM
JagerMech JM7-D.mtf	MM
Jagermech JM7-Da.mtf	MWL
JagerMech JM7-F.mtf	MM
JagerMech JM7-G.mtf	MWL
Jaguar (Standard).mtf	MM
Jaguar (Tarcomp).blk	MWL
Jaguar 2.mtf	MM
Jaguar.blk	MWL
Javelin JVN-10F Fire Javelin.mtf	MM
Javelin JVN-10N.mtf	MM
Javelin JVN-10P.mtf	MM
Javelin JVN-11A Fire Javelin.mtf	MM
Javelin JVN-11B.mtf	MM
Javelin JVN-11C.mtf	MWL
Javelin JVN-11D Farrell.mtf	MM
Javelin JVN-11D.mtf	MM
Javelin JVN-11F.mtf	MM
Javelin JVN-11P.mtf	MM
Javelin JVN-11V.mtf	MWL
Javelin JVN-12H.mtf	MWL
Jeep (Standard).blk	MM
Jengiz A.blk	MWL
Jengiz B.blk	MWL
Jengiz C.blk	MWL
Jengiz D.blk	MWL
Jengiz G.blk	MWL
Jengiz H.blk	MWL
Jengiz Prime.blk	MWL
Jengiz W.blk	MWL
Jenner IIC .mtf	MM
Jenner IIC 2.mtf	MM
Jenner IIC 3.mtf	MM
Jenner IIC 4.mtf	MM
Jenner IIC 5.mtf	MWL
Jenner JR10-X.mtf	MM
Jenner JR7-A.mtf	MM
Jenner JR7-C.mtf	MM
Jenner JR7-C2.mtf	MM
Jenner JR7-C3.mtf	MM
Jenner JR7-C4.mtf	MM
Jenner JR7-D.mtf	MM
Jenner JR7-F.mtf	MM
Jenner JR7-K Grace II.mtf	MM
Jenner JR7-K Grace.mtf	MM
Jenner JR7-K.mtf	MM
Jenner JR7-MI.mtf	MWL
Jenner JR7-X.mtf	MWL
Jenner JR7-XT.mtf	MWL
Jenner JR-8F.mtf	MWL
Jenner Samuli.mtf	MM
JES I Tactical Missile Carrier (3082 Upgrade).blk	MM
JES I Tactical Missile Carrier.blk	MM
JES II Strategic Missile  Carrier (Ammo).blk	MM
JES II Strategic Missile  Carrier (Dark Age).blk	MWL
JES II Strategic Missile  Carrier.blk	MM
JES II Strategic Missile Carrier (Support).blk	MM
JES III Missile Carrier (C3).blk	MM
JES III Missile Carrier (MML).blk	MM
JES III Missile Carrier (Speed).blk	MM
JES III Missile Carrier (Standard).blk	MM
JES III Missile Carrier (Thunderbolt).blk	MM
Jet Sled (Standard).blk	MM
JI2A1 Attack APC (MML).blk	MM
JI2A1 Attack APC (Standard).blk	MM
Jian (LRM).blk	MWL
Jian.blk	MWL
Jifty Transportable Field Repair Unit JI-50 (Hoist).blk	MM
Jifty Transportable Field Repair Unit JI-50 (MG).blk	MM
Jifty Transportable Field Repair Unit JI-50 (ML).blk	MM
Jifty Transportable Field Repair Unit JI-50 (Q-Vehicle).blk	MM
Jifty Transportable Field Repair Unit JI-50.blk	MM
Jinggau JN-G7L.mtf	MM
Jinggau JN-G8A.mtf	MM
Jinggau JN-G8BX Rush.mtf	MM
Jinggau JN-G9A.mtf	MWL
Jinggau JN-G9CC.mtf	MM
Joust Medium Tank BE700.blk	MM
Joust Medium Tank BE701.blk	MM
Juggernaut JG-R9T1.mtf	MM
Juggernaut JG-R9T2.mtf	MM
Juggernaut JG-R9T3.mtf	MM
Juggernaut JG-R9TX1 Leapin' Lil.mtf	MM
Juliano JLN-5A.mtf	MM
Jupiter .mtf	MM
Jupiter 2.mtf	MM
Jupiter 3.mtf	MM
Jupiter 4.mtf	MM
K-27 Ordnance Transport (Killjoy).blk	MM
Kabuto KBO-7A.mtf	MM
Kabuto KBO-7B.mtf	MM
Kage Light Battle Armor (DEST).blk	MM
Kage Light Battle Armor (Space).blk	MM
Kage Light Battle Armor (Vibro-Claw).blk	MM
Kage Light Battle Armor [ECM].blk	MM
Kage Light Battle Armor [Flamer].blk	MM
Kage Light Battle Armor [Laser].blk	MM
Kage Light Battle Armor [MG].blk	MM
Kage Light Battle Armor [TAG].blk	MM
Kage Light Battle Armor C.blk	MM
Kalki Cruise Missile Launcher .blk	MM
Kamakiri Attack VTOL (Gauss).blk	MM
Kamakiri Attack VTOL (Standard).blk	MM
Kanazuchi Assault Battle Armor (Upgrade) [Battle Claw].blk	MM
Kanazuchi Assault Battle Armor [Battle Claw].blk	MM
Kanazuchi Assault Battle Armor [Industrial Drill].blk	MM
Kanazuchi Assault Battle Armor [Salvage Arm].blk	MM
Kanazuchi Assault Battle Armor Cyclops.blk	MM
Kanga Medium Hovertank (AC).blk	MM
Kanga Medium Hovertank.blk	MM
Kangaroo (Guardian).blk	MWL
Kangaroo.blk	MWL
Kanga-X Jump Tank.blk	MM
Karhu A.mtf	MM
Karhu B.mtf	MM
Karhu C.mtf	MM
Karhu D.mtf	MM
Karhu G.mtf	MM
Karhu Prime.mtf	MM
Karhu Syngman.mtf	MM
Karnov UR Gunship.blk	MM
Karnov UR Transport (3055 Upgrade).blk	MM
Karnov UR Transport (AC).blk	MM
Karnov UR Transport (Artillery).blk	MM
Karnov UR Transport (BA).blk	MM
Karnov UR Transport (Periphery).blk	MM
Karnov UR Transport.blk	MM
Katana (Crockett) CRK-5003-2.mtf	MM
Katana (Crockett) CRK-5003-C.mtf	MM
Katana (Crockett) CRK-5003-CJ.mtf	MM
Katana (Crockett) CRK-5003-CM.mtf	MM
Katana (Crockett) CRK-5004-C.mtf	MWL
Katana (Crockett) CRK-5004-CM.mtf	MWL
Katana (Crockett) CRK-5004-CS.mtf	MWL
Katana CRK-5003-2.mtf	MWL
Katana CRK-5003-8W.mtf	MWL
Katana CRK-5009-KC.mtf	MWL
Katana Tank (Upgrade).blk	MWL
Katana.blk	MWL
Kelswa Assault Tank (Standard).blk	MM
Kestrel VTOL (Clan).blk	MM
Kestrel VTOL (MedEvac).blk	MM
Kestrel VTOL (ML).blk	MM
Kestrel VTOL (MWL).blk	MWL
Kestrel VTOL (SL).blk	MM
Kestrel VTOL (SRM).blk	MM
Kestrel VTOL Scout.blk	MM
Kestrel VTOL.blk	MM
Kheper KHP-7R.mtf	MM
King Crab IIC.mtf	MWL
King Crab KGC-000.mtf	MM
King Crab KGC-0000.mtf	MM
King Crab KGC-000b.mtf	MM
King Crab KGC-001.mtf	MM
King Crab KGC-001CS.mtf	MWL
King Crab KGC-001L.mtf	MWL
King Crab KGC-001U.mtf	MWL
King Crab KGC-001W.mtf	MWL
King Crab KGC-005.mtf	MM
King Crab KGC-005r.mtf	MM
King Crab KGC-007.mtf	MM
King Crab KGC-008.mtf	MM
King Crab KGC-008B.mtf	MM
King Crab KGC-009.mtf	MM
King Crab KGC-010.mtf	MM
King Crab KGC-011.mtf	MWL
King Crab KGC-IIC 2.mtf	MWL
King Crab KGC-IIC 3.mtf	MWL
Kingfisher A.mtf	MM
Kingfisher B.mtf	MM
Kingfisher C.mtf	MM
Kingfisher D.mtf	MM
Kingfisher E.mtf	MM
Kingfisher F.mtf	MM
Kingfisher H.mtf	MM
Kingfisher Prime.mtf	MM
Kingfisher X.mtf	MM
Kinnol MBT (PPC).blk	MM
Kinnol MBT (RAC).blk	MM
Kinnol MBT .blk	MM
Kintaro IIC.mtf	MWL
Kintaro KTO-18.mtf	MM
Kintaro KTO-19.mtf	MM
Kintaro KTO-19b.mtf	MM
Kintaro KTO-20.mtf	MM
Kintaro KTO-21.mtf	MM
Kintaro KTO-21B.mtf	MWL
Kintaro KTO-25K.mtf	MWL
Kintaro KTO-C.mtf	MM
Kintaro KTO-K.mtf	MM
Kirghiz A.blk	MWL
Kirghiz B.blk	MWL
Kirghiz C.blk	MWL
Kirghiz D.blk	MWL
Kirghiz E.blk	MWL
Kirghiz Prime.blk	MWL
Kishi Ceremonial Armor.blk	MM
Kiso Command Mech K-3N-KRHQ.mtf	MM
Kiso K-3N-KR4.mtf	MM
Kiso K-3N-KR5.mtf	MM
Kite Reconnaissance Vehicle.blk	MM
Kobold (Comstar).blk	MWL
Kobold (Comstar-Flamer).blk	MWL
Kobold (Comstar-TAG).blk	MWL
Kobold Battle Armor [GL Flamer] (CS).blk	MM
Kobold Battle Armor [GL Flamer] (GB).blk	MM
Kobold Battle Armor [GL Flamer].blk	MM
Kobold Battle Armor [GL SPL] (CS).blk	MM
Kobold Battle Armor [GL SPL] (GB).blk	MM
Kobold Battle Armor [GL SPL].blk	MM
Kobold Battle Armor [GL TAG] (CS).blk	MM
Kobold Battle Armor [GL TAG] (GB).blk	MM
Kobold Battle Armor [GL TAG].blk	MM
Kobold Battle Armor [SL Flamer] (CS).blk	MM
Kobold Battle Armor [SL Flamer] (GB).blk	MM
Kobold Battle Armor [SL Flamer].blk	MM
Kobold Battle Armor [SL TAG]  (CS).blk	MM
Kobold Battle Armor [SL TAG] (GB).blk	MM
Kobold Battle Armor [SL TAG].blk	MM
Kobold Battle Armor IIC.blk	MM
Kobold X-C3.blk	MM
Kodiak .mtf	MM
Kodiak 2.mtf	MM
Kodiak 3.mtf	MM
Kodiak 4.mtf	MM
Kodiak 5.mtf	MM
Kodiak Cale.mtf	MM
Kodiak II (Standard).mtf	MM
Kodiak II 2.mtf	MM
Kodiak KDK-RD.mtf	MWL
Komodo KIM-2.mtf	MM
Komodo KIM-2A.mtf	MM
Komodo KIM-2C.mtf	MM
Komodo KIM-2MX.mtf	MWL
Komodo KIM-3C.mtf	MM
Komodo KIM-4DC.mtf	MWL
Kopis Assault Battle Armor (AI Mk II).blk	MM
Kopis Assault Battle Armor (Anti-Infantry).blk	MM
Kopis Assault Battle Armor (Mortar).blk	MM
Kopis Assault Battle Armor AI Mk IIr.blk	MM
Kopis Assault Battle Armor.blk	MM
Korvin KRV-2.blk	MM
Korvin KRV-3.blk	MM
Korvin.blk	MWL
Koryu Submarine (Civilian).blk	MM
Koryu Submarine (Military).blk	MM
Koschei KSC-3I.mtf	MM
Koschei KSC-3L.mtf	MM
Koschei KSC-4I.mtf	MM
Koschei KSC-4L.mtf	MM
Koschei KSC-4V.mtf	MWL
Koschei KSC-5I.mtf	MM
Koschei KSC-5MC.mtf	MM
Koschei KSC-5X.mtf	MM
Koschei KSC-6L.mtf	MM
Koshi (Mist Lynx) A.mtf	MM
Koshi (Mist Lynx) B.mtf	MM
Koshi (Mist Lynx) C.mtf	MM
Koshi (Mist Lynx) D.mtf	MM
Koshi (Mist Lynx) E.mtf	MM
Koshi (Mist Lynx) F.mtf	MM
Koshi (Mist Lynx) G.mtf	MM
Koshi (Mist Lynx) H.mtf	MM
Koshi (Mist Lynx) P.mtf	MM
Koshi (Mist Lynx) Prime.mtf	MM
Koshi (Mist Lynx) S.mtf*	MWL
Koshi (Mist Lynx) Z.mtf	MM
Koshi (Standard) 2.mtf	MM
Koshi (Standard) 3.mtf	MM
Koshi (Standard).mtf	MM
Koshi 2.mtf	MWL
Koshi.mtf	MWL
Koto KTO-2A.mtf	MM
Koto KTO-3A.mtf	MM
Koto KTO-4A.mtf	MM
Koto KT-P2.mtf	MM
Kraken (Bane) 2.mtf	MM
Kraken (Bane) 3.mtf	MM
Kraken (Bane) 4.mtf	MM
Kraken (Bane).mtf	MM
Kraken-XR.mtf	MM
Krise PA(L) (Standard).blk	MM
Kruger Combat Car (Original).blk	MM
Kruger Combat Car (Standard).blk	MM
Ku Wheeled Assault Tank (IFV) Turhan II.blk	MWL
Ku Wheeled Assault Tank (IFV).blk	MM
Ku Wheeled Assault Tank.blk	MM
Kuma .mtf	MM
Kuma 2.mtf	MM
Kuma 3.mtf	MM
Kuma 4.mtf	MM
Kyudo KY2-D-01.mtf	MM
Kyudo KY2-D-02.mtf	MM
Kyudo KY2-D-03.mtf	MM
Lament LMT-2R.mtf	MM
Lament LMT-3C.mtf	MM
Lament LMT-3R.mtf	MM
Lament LMT-4RC.mtf	MM
Lamprey Transport Helicopter.blk	MM
Lancelot LNC25-01.mtf	MM
Lancelot LNC25-01sl.mtf	MM
Lancelot LNC25-01X.mtf	MM
Lancelot LNC25-02.mtf	MM
Lancelot LNC25-03.mtf	MM
Lancelot LNC25-04.mtf	MM
Lancelot LNC25-05.mtf	MM
Lancelot LNC25-06.mtf	MM
Lancelot LNC25-07.mtf	MM
Lancelot LNC25-08.mtf	MM
Lancelot LNC25-11.mtf	MWL
Lancelot LNC-IIC.mtf	MWL
Lancer LX-2.blk	MWL
Lancer LX-2A.blk	MWL
Lao Hu LHU-2B.mtf	MM
Lao Hu LHU-3B.mtf	MM
Lao Hu LHU-3C.mtf	MM
Lao Hu LHU-3C1.mtf	MWL
Lao Hu LHU-3L.mtf	MM
Lao Hu LHU-4B.mtf	MWL
Lao Hu LHU-4E.mtf	MM
Laser Carrier.blk	MM
Legacy LGC-01.mtf	MM
Legacy LGC-01X.mtf	MWL
Legacy LGC-02.mtf	MM
Legacy LGC-02M.mtf	MWL
Legacy LGC-03.mtf	MM
Legacy LGC-04.mtf	MWL
Legacy LGC-04-WVR.mtf	MM
Legacy LGC-05.mtf	MM
Legacy LGC-06.mtf	MWL
Legionnaire LGN-1X.mtf	MM
Legionnaire LGN-2D Raul.mtf	MM
Legionnaire LGN-2D.mtf	MM
Legionnaire LGN-2F.mtf	MM
Legionnaire LGN-2K.mtf	MM
Legionnaire LGN-2X1 MUSE FIRE.mtf	MM
Legionnaire LGN-2XA.mtf	MM
Legionnaire LGN-2XU.mtf	MM
Leonidas BA (David LGR).blk	MM
Leonidas BA (FireDrake).blk	MM
Leonidas BA (Improved Sensors).blk	MM
Leonidas BA (Light TAG).blk	MM
Leonidas BA (MG).blk	MM
Lexan Surveillance Helo (Prototype).blk	MM
Lexan Surveillance VTOL.blk	MM
Light SRM Carrier.blk	MM
Light Thunderbolt Carrier.blk	MM
Lightning Attack Hovercraft (ERML).blk	MM
Lightning Attack Hovercraft (ERSL).blk	MM
Lightning Attack Hovercraft (RL).blk	MM
Lightning Attack Hovercraft (Royal).blk	MM
Lightning Attack Hovercraft CX-3.blk	MM
Lightning Attack Hovercraft.blk	MM
Lightning IIC.blk	MWL
Lightning LTN-G15.blk	MWL
Lightning LTN-G15b.blk	MWL
Lightning LTN-G16D.blk	MWL
Lightning LTN-G16L.blk	MWL
Lightning LTN-G16O.blk	MWL
Lightning LTN-G16S.blk	MWL
Lightning LTN-G16T.blk	MWL
Lightray LGH-4W.mtf	MM
Lightray LGH-4Y.mtf	MM
Lightray LGH-5W.mtf	MM
Lightray LGH-6W.mtf	MM
Lightray LGH-7W.mtf	MM
Linebacker A.mtf	MM
Linebacker B.mtf	MM
Linebacker C.mtf	MM
Linebacker D.mtf	MM
Linebacker E.mtf	MM
Linebacker F.mtf	MM
Linebacker G.mtf	MM
Linebacker H.mtf	MM
Linebacker HM.mtf	MWL
Linebacker J.mtf	MWL
Linebacker Prime.mtf	MM
Lineholder KW1-LH2.mtf	MM
Lineholder KW1-LH3.mtf	MM
Lineholder KW1-LH8.mtf	MM
Lineholder KW2-LHW.mtf	MM
Lineholder KW3-LH2.mtf	MWL
Lineholder KW3-LHW.mtf	MWL
Lineholder KW5-LHW2.mtf	MWL
Lion Support Tank (Bombast Laser).blk	MWL
Lobo 2.mtf	MM
Lobo 3.mtf	MM
Lobo RC.mtf	MWL
Lobo.mtf	MM
Locust IIC .mtf	MM
Locust IIC 2.mtf	MM
Locust IIC 3.mtf	MM
Locust IIC 4.mtf	MM
Locust IIC 5.mtf	MM
Locust IIC 6.mtf	MM
Locust IIC 7.mtf	MM
Locust IIC 8.mtf	MM
Locust IIC 9.mtf	MM
Locust LCT-1E.mtf	MM
Locust LCT-1L.mtf	MM
Locust LCT-1M.mtf	MM
Locust LCT-1S.mtf	MM
Locust LCT-1V.mtf	MM
Locust LCT-1V2.mtf	MM
Locust LCT-1Vb.mtf	MM
Locust LCT-2E.mtf	MWL
Locust LCT-3D.mtf	MM
Locust LCT-3G.mtf	MWL
Locust LCT-3M.mtf	MM
Locust LCT-3S.mtf	MM
Locust LCT-3SS.mtf	MWL
Locust LCT-3V.mtf	MM
Locust LCT-5A.mtf	MWL
Locust LCT-5M.mtf	MM
Locust LCT-5M2.mtf	MM
Locust LCT-5M3.mtf	MM
Locust LCT-5T.mtf	MM
Locust LCT-5V.mtf	MM
Locust LCT-5W.mtf	MM
Locust LCT-5W2.mtf	MM
Locust LCT-5X.mtf	MWL
Locust LCT-6M.mtf	MM
Locust LCT-6V.mtf	MWL
Loki (Hellbringer) A.mtf	MM
Loki (Hellbringer) B.mtf	MM
Loki (Hellbringer) C.mtf	MM
Loki (Hellbringer) D.mtf	MM
Loki (Hellbringer) E.mtf	MM
Loki (Hellbringer) F.mtf	MM
Loki (Hellbringer) G.mtf	MM
Loki (Hellbringer) H.mtf	MM
Loki (Hellbringer) Mk II (Prime).mtf	MM
Loki (Hellbringer) Mk II A.mtf	MM
Loki (Hellbringer) Mk II B.mtf	MM
Loki (Hellbringer) Prime.mtf	MM
Longbow LGB-0C.mtf	MM
Longbow LGB-0W.mtf	MM
Longbow LGB-12C.mtf	MM
Longbow LGB-12KC.mtf	MWL
Longbow LGB-12M.mtf	MWL
Longbow LGB-12R.mtf	MM
Longbow LGB-13C.mtf	MM
Longbow LGB-13NAIS.mtf	MM
Longbow LGB-14C.mtf	MM
Longbow LGB-14C2.mtf	MM
Longbow LGB-7Q.mtf	MM
Longbow LGB-7V.mtf	MM
Longbow LGB-7VL.mtf	MWL
Longbow LGB-8S.mtf	MWL
Longbow LGB-8V.mtf	MM
Longinus Battle Armor (Magnetic) (WOB).blk	MM
Longinus Battle Armor (Magnetic).blk	MM
Longinus Battle Armor [David] (WoB).blk	MM
Longinus Battle Armor [David].blk	MM
Longinus Battle Armor [Flamer] (WoB).blk	MM
Longinus Battle Armor [Flamer].blk	MM
Longinus Battle Armor [Laser] (WoB).blk	MM
Longinus Battle Armor [Laser].blk	MM
Longinus Battle Armor [MG] (WoB).blk	MM
Longinus Battle Armor [MG].blk	MM
Longinus Battle Armor Hacked [David].blk	MM
Longinus Battle Armor Hacked [MG].blk	MM
Longshot LNG-1B.mtf	MM
Longshot LNG-2.mtf	MM
Longshot LNG-3.mtf	MM
Longshot LNG-3C.mtf	MM
Longshot LNG-4.mtf	MM
LRM Carrier (3055 Upgrade).blk	MM
LRM Carrier (CS-RK).blk	MWL
LRM Carrier (Laser).blk	MWL
LRM Carrier (WoB).blk	MM
LRM Carrier Primitive.blk	MM
LRM Carrier.blk	MM
LTV-4 Hover Tank.blk	MM
Lu Wei Bing LN-4B.mtf	MM
Lucifer II LCF-R16K.blk	MWL
Lucifer II LCF-R16KR.blk	MWL
Lucifer LCF-R15.blk	MWL
Lucifer LCF-R16.blk	MWL
Lucifer LCF-R20.blk	MWL
Lucifer LCF-X30.blk	MWL
Luduan Scout Vehicle.blk	MM
Lumberjack LM1A.mtf	MM
Lumberjack LM4C.mtf	MM
Lumberjack LM4P.mtf	MM
Lupus A.mtf	MM
Lupus B.mtf	MM
Lupus Prime.mtf	MM
Lynx LNX-10R.mtf	MWL
Lynx LNX-8Q.mtf	MM
Lynx LNX-9C.mtf	MM
Lynx LNX-9Cr.mtf	MWL
Lynx LNX-9Q.mtf	MM
Lynx LNX-9R.mtf	MM
M.A.S.H. Truck (ICE).blk	MM
M.A.S.H. Truck (Small).blk	MM
M.A.S.H. Truck.blk	MM
Mackie MSK-5S.mtf	MM
Mackie MSK-6S.mtf	MM
Mackie MSK-7A.mtf	MM
Mackie MSK-8B.mtf	MM
Mackie MSK-9H.mtf	MM
Mackie MSK-9HKR Kill Roys Little Buddy.mtf	MM
Mad Cat (Timber Wolf) A.mtf	MM
Mad Cat (Timber Wolf) B.mtf	MM
Mad Cat (Timber Wolf) B.mtf	MWL
Mad Cat (Timber Wolf) Bounty Hunter 2.mtf	MM
Mad Cat (Timber Wolf) Bounty Hunter.mtf	MM
Mad Cat (Timber Wolf) C.mtf	MM
Mad Cat (Timber Wolf) D.mtf	MM
Mad Cat (Timber Wolf) E.mtf	MM
Mad Cat (Timber Wolf) F.mtf	MM
Mad Cat (Timber Wolf) G.mtf	MWL
Mad Cat (Timber Wolf) H.mtf	MM
Mad Cat (Timber Wolf) J.mtf 	MWL
Mad Cat (Timber Wolf) O.mtf	MWL
Mad Cat (Timber Wolf) Prime.mtf	MM
Mad Cat (Timber Wolf) Pryde.mtf	MM
Mad Cat (Timber Wolf) S.mtf	MM
Mad Cat (Timber Wolf) U.mtf	MM
Mad Cat (Timber Wolf) W.mtf	MWL
Mad Cat (Timber Wolf) Z.mtf	MM
Mad Cat III (Eve).mtf	MM
Mad Cat III (Standard).mtf	MM
Mad Cat III 2.mtf	MM
Mad Cat III 3.mtf	MM
Mad Cat III 4.mtf	MM
Mad Cat III 5.mtf	MM
Mad Cat III Dark Age RS .mtf	MM
Mad Cat III X.mtf	MM
Mad Cat III.mtf	MWL
Mad Cat III-S.mtf	MWL
Mad Cat Mk II  2 HA.mtf	MWL
Mad Cat Mk II 2.mtf	MM
Mad Cat Mk II 3.mtf	MM
Mad Cat Mk II 4.mtf	MM
Mad Cat Mk II 5.mtf	MM
Mad Cat Mk II 6.mtf	MM
Mad Cat Mk II Enhanced.mtf	MM
Mad Cat Mk II.mtf	MM
Mad Cat Mk IV (Prime).mtf	MM
Mad Cat Mk IV A.mtf	MM
Mad Cat Mk IV B.mtf	MM
Mad Cat Mk IV C.mtf	MM
Mad Cat Mk IV PR 2.mtf	MM
Mad Cat Mk IV PR.mtf	MM
Maelstrom MTR-5K.mtf	MM
Maelstrom MTR-6E.mtf	MM
Maelstrom MTR-6K.mtf	MM
Maelstrom MTR-6X.mtf	MWL
Maelstrom MTR-7K.mtf	MM
Magi (UCSV).blk	MWL
Magi Infantry Support Vehicle (CS-RK).blk	MWL
Magi Infantry Support Vehicle (UCSV).blk	MM
Magi Infantry Support Vehicle.blk	MM
Magi.blk	MWL
Main Gauche Light Support Tank (C3).blk	MM
Main Gauche Light Support Tank (LB-X).blk	MWL
Main Gauche Light Support Tank (XL).blk	MM
Main Gauche Light Support Tank (XL-LB).blk	MWL
Main Gauche Light Support Tank IFV.blk	MM
Main Gauche Light Support Tank.blk	MM
Malak C-MK-O Alphon.mtf	MWL
Malak C-MK-O Comminus.mtf	MWL
Malak C-MK-O Dominus.mtf	MWL
Malak C-MK-O Eminus.mtf	MWL
Malak C-MK-O Exanimus.mtf	MWL
Malak C-MK-O Infernus.mtf	MWL
Malak C-MK-O Invictus.mtf	MM
Malak C-MK-O Invictus.mtf	MWL
Malak C-MK-O Luminos.mtf	MWL
Malak C-MK-O Maion.mtf	MWL
Malak C-MK-O Mi.mtf	MM
Malak C-MK-O Rashnu.mtf	MWL
Malak C-MK-OA Dominus.mtf	MM
Malak C-MK-OB Infernus.mtf	MM
Malak C-MK-OC Comminus.mtf	MM
Malak C-MK-OD Luminos.mtf	MM
Malak C-MK-OE Eminus.mtf	MM
Malak C-MK-OS Caelestis.mtf	MM
Malice MAL-XP.mtf	MM
Malice MAL-XT.mtf	MM
Malice MAL-XV.mtf	MM
Malice MAL-XY.mtf	MM
Mamono IFV (Standard).blk	MM
Man O' War (Gargoyle) (Conal).mtf	MM
Man O' War (Gargoyle) A.mtf	MM
Man O' War (Gargoyle) B.mtf	MM
Man O' War (Gargoyle) C.mtf	MM
Man O' War (Gargoyle) CR.mtf	MWL
Man O' War (Gargoyle) D.mtf	MM
Man O' War (Gargoyle) E.mtf	MM
Man O' War (Gargoyle) G.mtf	MM
Man O' War (Gargoyle) H.mtf	MM
Man O' War (Gargoyle) I.mtf	MWL
Man O' War (Gargoyle) M.mtf	MM
Man O' War (Gargoyle) Prime.mtf	MM
Man O' War (Gargoyle) T.mtf	MM
Mandrill .mtf	MM
Mandrill 2.mtf	MWL
Mandrill 3.mtf	MWL
Mangonel MNL-3L.mtf	MM
Mangonel MNL-3W.mtf	MM
Mangonel MNL-4S.mtf	MM
Manteuffel Attack Tank A.blk	MM
Manteuffel Attack Tank B.blk	MM
Manteuffel Attack Tank C.blk	MM
Manteuffel Attack Tank D.blk	MM
Manteuffel Attack Tank E.blk	MM
Manteuffel Attack Tank Prime.blk	MM
Manticore Heavy Tank (3055 Upgrade).blk	MM
Manticore Heavy Tank (BLAZER).blk	MWL
Manticore Heavy Tank (C3i).blk	MWL
Manticore Heavy Tank (C3M).blk	MM
Manticore Heavy Tank (C3S).blk	MM
Manticore Heavy Tank (HPPC).blk	MM
Manticore Heavy Tank (HVAC).blk	MWL
Manticore Heavy Tank (LB-X).blk	MM
Manticore Heavy Tank (RAC).blk	MM
Manticore Heavy Tank (Stealth).blk	MWL
Manticore Heavy Tank (X).blk	MWL
Manticore Heavy Tank.blk	MM
Manticore II Heavy Tank (Standard).blk	MM
Manticore The Ballista.blk	MM
Mantis Light Attack VTOL (ECCM).blk	MM
Mantis Light Attack VTOL.blk	MM
Mantis MTS-L.mtf	MM
Mantis MTS-S.mtf	MM
Mantis MTS-T.mtf	MM
Mantis MTS-T2.mtf	MM
Mantis MTS-T3.mtf	MM
Mantis SA-MN.mtf	MM
Marauder BattleArmor MH.blk	MM
Marauder BattleArmor.blk	MM
Marauder Bounty Hunter 3015.mtf	MM
Marauder Bounty Hunter 3044.mtf	MM
Marauder C.mtf	MM
Marauder II Bounty Hunter.mtf	MM
Marauder II C.mtf	MM
Marauder II MAD-4A.mtf	MM
Marauder II MAD-4CS.mtf	MWL
Marauder II MAD-4DM.mtf	MWL
Marauder II MAD-4H.mtf	MM
Marauder II MAD-4K.mtf	MM
Marauder II MAD-4L.mtf	MM
Marauder II MAD-4S.mtf	MM
Marauder II MAD-5A.mtf	MM
Marauder II MAD-5B.mtf	MM
Marauder II MAD-5C.mtf	MM
Marauder II MAD-5W.mtf	MM
Marauder II MAD-6D.mtf	MM
Marauder II MAD-6M.mtf	MM
Marauder II MAD-8X.mtf	MWL
Marauder IIC .mtf	MM
Marauder IIC 2.mtf	MM
Marauder IIC 3.mtf	MM
Marauder IIC 4.mtf	MM
Marauder IIC 5.mtf	MM
Marauder IIC 6.mtf	MM
Marauder IIC 7.mtf	MM
Marauder IIC 8.mtf	MM
Marauder MAD-1R.mtf	MM
Marauder MAD-2MAF.mtf	MWL
Marauder MAD-2R.mtf	MM
Marauder MAD-2RP.mtf	MWL
Marauder MAD-3D.mtf	MM
Marauder MAD-3L.mtf	MM
Marauder MAD-3LC.mtf	MWL
Marauder MAD-3M.mtf	MM
Marauder MAD-3MC.mtf	MWL
Marauder MAD-3R.mtf	MM
Marauder MAD-3TC.mtf	MWL
Marauder MAD-4CS.mtf	MWL
Marauder MAD-4X.mtf	MM
Marauder MAD-5CS.mtf	MWL
Marauder MAD-5D.mtf	MM
Marauder MAD-5D-K.mtf	MWL
Marauder MAD-5L.mtf	MM
Marauder MAD-5LL.mtf	MWL
Marauder MAD-5M.mtf	MM
Marauder MAD-5M2.mtf	MWL
Marauder MAD-5R.mtf	MM
Marauder MAD-5S.mtf	MM
Marauder MAD-5SS Champion.mtf	MWL
Marauder MAD-5T.mtf	MM
Marauder MAD-5T2 Sentinal.mtf	MWL
Marauder MAD-5TC.mtf	MWL
Marauder MAD-6L.mtf	MM
Marauder MAD-6S.mtf	MWL
Marauder MAD-7CCAF.mtf	MWL
Marauder MAD-7D.mtf	MM
Marauder MAD-7SB.mtf	MWL
Marauder MAD-9D.mtf	MM
Marauder MAD-9K.mtf	MWL
Marauder MAD-9M.mtf	MM
Marauder MAD-9M2.mtf	MM
Marauder MAD-9Mx.mtf	MWL
Marauder MAD-9S.mtf	MM
Marauder MAD-9W.mtf	MM
Marauder MAD-9W2.mtf	MM
Marauder MAD-SD Douglass.mtf	MM
Marco MR-8C.mtf	MM
Marco MR-8D.mtf	MM
Marco MR-8E.mtf	MM
Marksman (AC).blk	MWL
Marksman (LPPC).blk	MWL
Marksman Artillery Vehicle (AC).blk	MM
Marksman Artillery Vehicle (Light PPC).blk	MM
Marksman Artillery Vehicle.blk	MM
Marksman M1 MBT.blk	MM
Marksman M1A MBT.blk	MM
Marksman MBT M1J.blk	MM
Marksman.blk	MWL
Mars Assault Vehicle (ATM).blk	MM
Mars Assault Vehicle (HAG).blk	MM
Mars Assault Vehicle (XL).blk	MM
Mars Assault Vehicle.blk	MM
Marsden I.blk	MM
Marsden II MBT II (Primitive).blk	MM
Marsden II MBT II-A (LBX).blk	MM
Marsden II MBT II-A.blk	MM
Marsden II MBT.blk	MM
Marsden II.blk	MWL
Marsden II-A (LB-X).blk	MWL
Marsden II-A.blk	MWL
Marshal MHL-2L.mtf	MM
Marshal MHL-3MC.mtf	MM
Marshal MHL-6MC.mtf	MM
Marshal MHL-X1.mtf	MM
Marten Scout VTOL (Infantry).blk	MM
Marten Scout VTOL (Standard).blk	MM
Masakari (Warhawk) A.mtf	MM
Masakari (Warhawk) B.mtf	MM
Masakari (Warhawk) C.mtf	MM
Masakari (Warhawk) D.mtf	MM
Masakari (Warhawk) E.mtf	MM
Masakari (Warhawk) F.mtf	MM
Masakari (Warhawk) H.mtf	MM
Masakari (Warhawk) Prime.mtf	MM
Matador .mtf	MM
Matador 2.mtf	MM
Matador 3.mtf	MWL
Mauler MAL-1K.mtf	MM
Mauler MAL-1R.mtf	MM
Mauler MAL-2K.mtf	MWL
Mauler MAL-2R.mtf	MM
Mauler MAL-3R.mtf	MM
Mauler MAL-3RC.mtf	MWL
Mauler MAL-3RZ.mtf	MWL
Mauler MAL-C.mtf	MM
Maultier Hover APC (BA).blk	MM
Maultier Hover APC (Basic).blk	MM
Maultier Hover APC (Fusion).blk	MM
Maultier Hover APC (Intermediate).blk	MM
Maultier Hover APC (MG).blk	MM
Maultier Hover APC.blk	MM
Mauna Kea Command Vessel (LB-X).blk	MM
Mauna Kea Command Vessel (LRM).blk	MM
Mauna Kea Command Vessel (LRT).blk	MM
Mauna Kea Command Vessel.blk	MM
Maxim (I) Heavy Hover Transport (C3M).blk	MWL
Maxim (I) Heavy Hover Transport (C3S).blk	MWL
Maxim (I) Heavy Hover Transport (Company Command).blk	MM
Maxim (I) Heavy Hover Transport.blk	MM
Maxim Flanker.blk	MM
Maxim Heavy Hover Transport (3052 Upgrade).blk	MM
Maxim Heavy Hover Transport (Anti-Personnel).blk	MM
Maxim Heavy Hover Transport (BA Factory Upgrade).blk	MM
Maxim Heavy Hover Transport (BA Field Upgrade).blk	MM
Maxim Heavy Hover Transport (C3 reactive).blk	MWL
Maxim Heavy Hover Transport (C3i LRM).blk	MWL
Maxim Heavy Hover Transport (C3i).blk	MWL
Maxim Heavy Hover Transport (C3M).blk	MM
Maxim Heavy Hover Transport (C3S).blk	MM
Maxim Heavy Hover Transport (Clan).blk	MM
Maxim Heavy Hover Transport (Fire Support).blk	MM
Maxim Heavy Hover Transport (MML).blk	MWL
Maxim Heavy Hover Transport (SRM).blk	MWL
Maxim Heavy Hover Transport (SRM2).blk	MM
Maxim Heavy Hover Transport (SRM4).blk	MM
Maxim Heavy Hover Transport.blk	MM
Maxim Mk II Transport (ECM).blk	MM
Maxim Mk II Transport (Infantry Support).blk	MM
Maxim Mk II Transport.blk	MM
Men Shen MS1-O J.mtf	MWL
Men Shen MS1-O NV.mtf	MWL
Men Shen MS1-O.mtf 	MM
Men Shen MS1-OA.mtf	MM
Men Shen MS1-OB.mtf	MM
Men Shen MS1-OC.mtf	MM
Men Shen MS1-OD.mtf	MM
Men Shen MS1-OE.mtf	MM
Men Shen MS1-OF.mtf	MM
Men Shen MS1-OG.mtf	MM
Men Shen MS1-OU.mtf	MM
Mengqin MNG-8L.blk	MWL
Mercury II MCY-100.mtf	MM
Mercury MCY-102.mtf	MM
Mercury MCY-104.mtf	MM
Mercury MCY-97.mtf	MM
Mercury MCY-98.mtf	MM
Mercury MCY-99.mtf	MM
Merkava Heavy Tank Mk IX.blk	MM
Merkava Heavy Tank MK VI.blk	MM
Merkava Heavy Tank Mk VII.blk	MM
Merkava Heavy Tank Mk VIII.blk	MM
Merkava Mk XVII (AMS).blk	MWL
Merkava Mk XVII.blk	MWL
Merlin MLN-1A.mtf	MM
Merlin MLN-1B.mtf	MM
Merlin MLN-1C.mtf	MM
Merlin MLN-2A.mtf	MWL
Merlin MLN-2C.mtf	MWL
Merlin MLN-3C.mtf	MWL
Merlin MLN-RA.mtf	MWL
Merlin MLN-SX.mtf	MM
Merlin Porter.mtf	MM
MHI Amphibious APC (Standard).blk	MM
MHI Defense AA Tank (Standard).blk	MM
Mifeng Gunship .blk	MWL
Minion Advanced Tactical Vehicle (Gauss).blk	MWL
Minion Advanced Tactical Vehicle (TAG).blk	MM
Minion Advanced Tactical Vehicle (Targeting Computer).blk	MM
Minion Advanced Tactical Vehicle Magshot.blk	MM
Minion Advanced Tactical Vehicle Silver Bullet.blk	MM
Minion Advanced Tactical Vehicle.blk	MM
MIT23 MASH Vehicle.blk	MM
MIT24 MASH Vehicle (Standard).blk	MM
Mithras Light Tank (ERLL).blk	MM
Mithras Light Tank.blk	MM
Mjolnir MLR-B2.mtf	MM
Mjolnir MLR-BX.mtf	MM
Mobile Headquarters (ICE - LL).blk	MM
Mobile Headquarters (ICE - LRM).blk	MM
Mobile Headquarters (ICE).blk	MM
Mobile Headquarters (LL).blk	MM
Mobile Headquarters (LRM).blk	MM
Mobile Headquarters.blk	MM
Mobile Long Tom (Ammo Carriage).blk	MM
Mobile Long Tom (Support Carriage).blk	MM
Mobile Long Tom Artillery (Unofficial).blk	MM
Mobile Long Tom Artillery.blk	MWL
Mobile Long Tom LT-MOB-25.blk	MM
Mobile Sniper Artillery .blk	MWL
Mobile Tactical Command HQ.blk	MM
Mobile Thumper Artillery .blk	MWL
Moltke M1 MBT.blk	MM
Moltke M2 MBT.blk	MM
Moltke M3 MBT.blk	MM
Moltke Main Battle Tank M-1.blk	MWL
Moltke Main Battle Tank M-2.blk	MWL
Mongoose II MON-266.mtf	MM
Mongoose II MON-267.mtf	MM
Mongoose II MON-268.mtf	MM
Mongoose MON-66.mtf	MM
Mongoose MON-66b.mtf	MM
Mongoose MON-66GX Gunslinger.mtf	MM
Mongoose MON-67.mtf	MM
Mongoose MON-68.mtf	MM
Mongoose MON-69.mtf	MM
Mongoose MON-70.mtf	MM
Mongoose MON-76.mtf	MM
Mongoose MON-86.mtf	MM
Mongoose MON-96.mtf	MWL
Mongrel MGL-T1.mtf	MM
Mongrel MGL-T2.mtf	MM
Monitor Naval Vessel.blk	MM
Montgomery II.blk	MWL
Morgenstern MR-1S.blk	MWL
Morgenstern MR-1SA.blk	MWL
Morgenstern MR-1SB.blk	MWL
Morgenstern MR-1SC.blk	MWL
Morgenstern MR-1SD.blk	MWL
Morningstar City Command Vehicle (Company Command).blk	MM
Morningstar City Command Vehicle (Laser).blk	MM
Morningstar City Command Vehicle [HPG].blk	MM
Morningstar City Command Vehicle.blk	MM
Morpheus MR-P1.mtf	MM
Morpheus MRP-3S.mtf	MM
Morpheus MRP-3T.mtf	MM
Morpheus MRP-3W.mtf	MM
Morrigan 2.mtf	MM
Morrigan 3.mtf	MM
Morrigan 4.mtf	MM
Morrigan 5.mtf	MM
Morrigan.mtf	MM
Morrigu Fire Support Vehicle (HAG).blk	MM
Morrigu Fire Support Vehicle (Laser).blk	MM
Morrigu Fire Support Vehicle.blk	MM
Mortar Carrier (Standard).blk	MM
Mortis MS-1A.mtf	MM
Mortis MS-1P.mtf	MM
Mosquito Light Fighter.blk	MM
MRM Carrier.blk	MM
Musketeer Hover Tank (3080 Upgrade).blk	MM
Musketeer Hover Tank (Armor).blk	MM
Musketeer Hover Tank.blk	MM
Myrmidon Medium Tank (Anti-Infantry).blk	MM
Myrmidon Medium Tank (MG).blk	MWL
Myrmidon Medium Tank P (Tate).blk	MM
Myrmidon Medium Tank Type 2.blk	MM
Myrmidon Medium Tank.blk	MM
Nacon Armored Scout (Standard).blk	MM
Naga A.mtf	MM
Naga B.mtf	MM
Naga C.mtf	MM
Naga D.mtf	MM
Naga Prime.mtf	MM
Naginata NC-C3Ar.mtf	MM
Naginata NG-C3A.mtf	MM
Naginata NG-C3B.mtf	MM
Naginata NG-C3C.mtf	MM
Naginata NG-C3KC.mtf	MWL
Naginata NG-C4C Nagamaki.mtf	MWL
Naginata NG-C4H.mtf	MWL
Naifu Attack VTOL (Standard).blk	MWL
Narumkami Heavy Tank NK-1C.blk	MM
Narumkami Heavy Tank NK-BC3.blk	MM
Neanderthal NTL-AG.mtf	MM
Neanderthal NTL-UG.mtf	MM
Nemera Mk XI.blk	MWL
Nephilim Assault Battle Armor (Capture Team)[HMG].blk	MM
Nephilim Assault Battle Armor (Gauss).blk	MM
Nephilim Assault Battle Armor (Narc).blk	MM
Nephilim Assault Battle Armor (Seeker) [MG].blk	MM
Nephilim Assault Battle Armor (Support).blk	MM
Nephilim Assault Battle Armor [Standard].blk	MM
Neptune Submarine (Hunter-Killer).blk	MM
Neptune Submarine (LRT).blk	MM
Neptune Submarine (SRT).blk	MM
Neptune Submarine.blk	MM
Nexus II NXS2-A.mtf	MM
Nexus II NXS2-B.mtf	MM
Nexus II NXS2-C.mtf	MWL
Nexus NXS1-A.mtf	MM
Nexus NXS1-B.mtf	MM
Night Gyr A.mtf	MM
Night Gyr B.mtf	MM
Night Gyr C.mtf	MM
Night Gyr D.mtf	MM
Night Gyr E.mtf	MM
Night Gyr F.mtf	MM
Night Gyr G.mtf	MWL
Night Gyr H.mtf	MM
Night Gyr I.mtf	MWL
Night Gyr J.mtf	MWL
Night Gyr Prime.mtf	MM
Night Gyr V.mtf	MWL
Night Hawk NTK-2Q.mtf	MM
Night Hawk NTK-2S.mtf	MM
Night Hawk NTK-3RK.mtf	MWL
Night Hawk NTK-7S.mtf	MWL
Night Hawk NTK-RA.mtf	MWL
Night Stalker NSR-K1.mtf	MM
Night Stalker NSR-K3.mtf	MM
Night Stalker NSR-K4.mtf	MM
Night Stalker NSR-K7.mtf	MM
Night Stalker NSR-KC.mtf	MM
Night Wolf 2.mtf	MWL
Night Wolf.mtf	MM
Nighthawk PA(L) Mk. XXI.blk	MM
Nighthawk PA(L) Mk. XXII.blk	MM
Nighthawk PA(L) Mk. XXX (Bounty Hunter).blk	MM
Nighthawk PA(L) Mk. XXX.blk	MM
Nightshade (Royal).blk	MWL
Nightshade (WoB).blk	MWL
Nightshade ECM VTOL (Armor).blk	MM
Nightshade ECM VTOL (LAC).blk	MM
Nightshade ECM VTOL (Light PPC).blk	MM
Nightshade ECM VTOL (Royal).blk	MM
Nightshade ECM VTOL.blk	MM
Nightsky NGS-4S.mtf	MM
Nightsky NGS-4T.mtf	MM
Nightsky NGS-4X.mtf	MWL
Nightsky NGS-5S.mtf	MM
Nightsky NGS-5T.mtf	MM
Nightsky NGS-6S.mtf	MM
Nightsky NGS-6T.mtf	MM
Nightsky NGS-7S.mtf	MWL
Nightsky NGS-7ST.mtf	MWL
Nightsky NGS-8S.mtf	MWL
Nightstar NSR-8F.mtf	MWL
Nightstar NSR-9FC.mtf	MM
Nightstar NSR-9FCS.mtf	MWL
Nightstar NSR-9FS.mtf	MWL
Nightstar NSR-9J Brubaker.mtf	MM
Nightstar NSR-9J.mtf	MM
Nightstar NSR-9JS.mtf	MWL
Nightstar NSR-9SS.mtf	MM
Nike Tank.blk	MM
Ninja-To NJT-2.mtf	MM
Ninja-To NJT-3.mtf	MM
Ninja-To NJT-4.mtf	MM
Ninja-To NJT-5.mtf	MWL
Nishikigoi Koi Variant.blk	MM
Nisos Attack WIGE (Standard).blk	MM
Nisos Attack WIGE (Support).blk	MM
No Dashi NDA-3X.mtf	MM
Nobori-nin (Huntsman) A.mtf	MM
Nobori-nin (Huntsman) B.mtf	MM
Nobori-nin (Huntsman) C.mtf	MM
Nobori-nin (Huntsman) D.mtf	MM
Nobori-nin (Huntsman) E.mtf	MM
Nobori-nin (Huntsman) F.mtf	MM
Nobori-nin (Huntsman) H.mtf	MM
Nobori-nin (Huntsman) N.mtf	MM
Nobori-nin (Huntsman) Prime.mtf	MM
No-Dachi NDA-1K.mtf	MM
No-Dachi NDA-2K.mtf	MM
No-Dachi NDA-2KC.mtf	MM
No-Dachi NDA-2KO.mtf	MM
No-Dachi NDA-3K.mtf	MWL
No-Dachi NDA-3S.mtf	MM
No-Dachi NDA-4X.mtf	MWL
Nova A.mtf*	MWL
Nova B.mtf*	MWL
Nova C.mtf*	MWL
Nova Cat A.mtf	MM
Nova Cat B.mtf	MM
Nova Cat C.mtf	MM
Nova Cat D.mtf	MM
Nova Cat E.mtf	MM
Nova Cat F.mtf	MM
Nova Cat G.mtf	MM
Nova Cat H.mtf	MM
Nova Cat I.mtf	MM
Nova Cat Prime.mtf	MM
Nuberu Anti Aircraft Tank 2 Numantia.blk	MM
Nuberu Anti Aircraft Tank.blk	MM
Nyx NX-100.mtf	MM
Nyx NX-100C.mtf	MWL
Nyx NX-110.mtf	MM
Nyx NX-80.mtf	MM
Nyx NX-80C.mtf	MM
Nyx NX-90.mtf	MM
Nyx NX-90K.mtf	MWL
Nyx NX-90S.mtf	MWL
O-65 'Oppie' Hazardous Materials Recovery Vehicle O-66 HMRV.blk	MM
O-66 'Oppie' Hazardous Materials Recovery Vehicle O-66 HMRV.blk	MM
O-Bakemono OBK-M10.mtf	MM
O-Bakemono OBK-M11.mtf	MM
O-Bakemono OBK-M11KC.mtf	MWL
O-Bakemono OBK-M12.mtf	MM
O-Bakemono OBK-M13.mtf	MWL
O-Bakemono OBK-M14.mtf	MWL
Ocelot .mtf	MM
Ocelot 2.mtf	MM
Ocelot 3.mtf	MM
Ocelot 4.mtf	MM
Ocelot II (RCV).blk	MWL
Ocelot II.blk	MWL
Odin Scout Tank (Spotter).blk	MM
Odin Scout Tank.blk	MM
Ogre BA (Interdictor).blk	MM
Ogre BA (Standard).blk	MM
OMEGA SHP-4X.mtf	MM
Omen 2.mtf	MM
Omen.mtf	MM
Onager 2.mtf	MM
Onager.mtf	MM
Oni Battle Armor [Narc].blk	MM
Oni Battlearmor Bearhunter.blk	MM
Oni Battlearmor MRR.blk	MM
Oni Battlearmor PPC.blk	MM
Oni ON-1.blk	MWL
Onslaught SA-OS.mtf	MM
Onslaught SA-OS2.mtf	MM
Onslaught SA-OS3.mtf	MM
Ontos Heavy Tank (3053 Upgrade).blk	MM
Ontos Heavy Tank (3053).blk	MWL
Ontos Heavy Tank (Fusion).blk	MM
Ontos Heavy Tank (Light Gauss XL).blk	MWL
Ontos Heavy Tank (Light Gauss).blk	MM
Ontos Heavy Tank (LPPC).blk	MWL
Ontos Heavy Tank (LRM).blk	MM
Ontos Heavy Tank (MML).blk	MM
Ontos Heavy Tank (Sealed).blk	MM
Ontos Heavy Tank Heat.blk	MM
Ontos Heavy Tank X.blk	MM
Ontos Heavy Tank.blk	MM
Orion IIC .mtf	MM
Orion IIC 6.mtf	MWL
Orion ON1-K (Kerensky).mtf	MM
Orion ON1-K.mtf	MM
Orion ON1-M.mtf	MM
Orion ON1-MA.mtf	MM
Orion ON1-MB.mtf	MM
Orion ON1-MC.mtf	MM
Orion ON1-MD.mtf	MM
Orion ON1-M-DC.mtf	MM
Orion ON1-V.mtf	MM
Orion ON1-VA.mtf	MM
Orion ON1-V-DC.mtf	MM
Orion ON2-M.mtf	MM
Orion ON2-W.mtf	MWL
Orion ON3-M.mtf	MM
Orion ON3-MX.mtf	MM
Orion ON4-M.mtf	MWL
Orion ON5-VA.mtf	MWL
Oro Heavy Tank (HAG).blk	MM
Oro Heavy Tank.blk	MM
Orochi OR-2I.mtf	MM
Osiris OSR-3D.mtf	MM
Osiris OSR-4D.mtf	MM
Osiris OSR-5D.mtf	MM
Osiris OSR-7D.mtf	MWL
Osprey OSP-15.mtf	MM
Osprey OSP-25.mtf	MM
Osprey OSP-26 Lawrence.mtf	MM
Osprey OSP-26.mtf	MM
Osteon (Jaguar).mtf	MM
Osteon A.mtf	MM
Osteon B.mtf	MM
Osteon C.mtf	MM
Osteon D.mtf	MM
Osteon E.mtf	MM
Osteon F.mtf	MM
Osteon G.mtf	MM
Osteon Prime.mtf	MM
Osteon U.mtf	MM
Ostroc OSR-2C Michi.mtf	MM
Ostroc OSR-2C.mtf	MM
Ostroc OSR-2Cb.mtf	MM
Ostroc OSR-2D.mtf	MM
Ostroc OSR-2L.mtf	MM
Ostroc OSR-2M.mtf	MM
Ostroc OSR-3C.mtf	MM
Ostroc OSR-3L.mtf	MWL
Ostroc OSR-4C.mtf	MM
Ostroc OSR-4K.mtf	MM
Ostroc OSR-4L.mtf	MM
Ostroc OSR-4LL.mtf	MWL
Ostroc OSR-4MC.mtf	MWL
Ostroc OSR-4RL.mtf	MWL
Ostroc OSR-4T.mtf	MWL
Ostroc OSR-5C.mtf	MM
Ostroc OSR-5W Ruff.mtf	MWL
Ostroc OSR-5W.mtf	MM
Ostroc OSR-6R.mtf	MWL
Ostrogoth A.blk	MWL
Ostrogoth B.blk	MWL
Ostrogoth C.blk	MWL
Ostrogoth Prime.blk	MWL
Ostscout OTT-10CS.mtf	MM
Ostscout OTT-10S.mtf	MWL
Ostscout OTT-11CS.mtf	MWL
Ostscout OTT-11J.mtf	MM
Ostscout OTT-7J.mtf	MM
Ostscout OTT-7Jb.mtf	MM
Ostscout OTT-7K.mtf	MM
Ostscout OTT-9CS.mtf	MM
Ostscout OTT-9S.mtf	MM
Ostsol OTL-4D.mtf	MM
Ostsol OTL-4F.mtf	MM
Ostsol OTL-5D.mtf	MM
Ostsol OTL-5M.mtf	MM
Ostsol OTL-6D.mtf	MM
Ostsol OTL-7M.mtf	MM
Ostsol OTL-8D.mtf	MM
Ostsol OTL-8M.mtf	MM
Ostsol OTL-9M.mtf	MM
Ostsol OTL-9M2.mtf	MWL
Ostsol OTL-9R.mtf	MM
Ostwar OWR-2M.mtf	MM
Ostwar OWR-2Mb.mtf	MM
Ostwar OWR-3M.mtf	MM
Owens OW-1 K.mtf	MWL
Owens OW-1.mtf	MM
Owens OW-1A.mtf	MM
Owens OW-1B.mtf	MM
Owens OW-1C.mtf	MM
Owens OW-1D.mtf	MM
Owens OW-1E.mtf	MM
Owens OW-1F.mtf	MM
Owens OW-1G.mtf	MM
Owens OW-1R.mtf	MM
PAB-28 Sniper Suit.blk	MM
Pack Hunter .mtf	MM
Pack Hunter 2.mtf	MM
Pack Hunter 3.mtf	MM
Pack Hunter 4.mtf	MM
Pack Hunter II .mtf	MM
Pack Hunter II 2.mtf	MM
Pack Hunter II 3.mtf	MM
Pack Hunter II 4.mtf	MM
Pack Hunter II Isis.mtf	MM
Packrat Gespenst.blk	MM
Packrat LRPV PKR-T5 (ICE).blk	MM
Packrat LRPV PKR-T5 (ML).blk	MM
Packrat LRPV PKR-T5 (SRM2).blk	MM
Packrat LRPV PKR-T5.blk	MM
Padilla Heavy Artillery Tank (LRM).blk	MM
Padilla Heavy Artillery Tank.blk	MM
Padilla Tube Artillery Tank (LTC).blk	MM
Padilla Tube Artillery Tank (Thumper).blk	MM
Padilla Tube Artillery Tank.blk	MM
Paladin Defense System (Standard).blk	MM
Paladin PAL-1.mtf	MM
Paladin PAL-2.mtf	MM
Paladin PAL-3.mtf	MM
Palmoni Assault Infantry Fighting Vehicle.blk	MM
Pandarus LFA-1A.mtf	MM
Pandarus LFA-1X.mtf	MM
Pandion Combat WiGE (C3).blk	MM
Pandion Combat WiGE (Infantry).blk	MM
Pandion Combat WiGE.blk	MM
Panther PNT-10G.mtf	MWL
Panther PNT-10K.mtf	MM
Panther PNT-10K2.mtf	MM
Panther PNT-10KA.mtf	MM
Panther PNT-10RG.mtf	MWL
Panther PNT-12A.mtf	MM
Panther PNT-12K.mtf	MM
Panther PNT-12K2.mtf	MM
Panther PNT-12KC.mtf	MM
Panther PNT-13K.mtf	MM
Panther PNT-14S.mtf	MM
Panther PNT-16K.mtf	MM
Panther PNT-22K.mtf	MWL
Panther PNT-8Z.mtf	MM
Panther PNT-9R.mtf	MM
Panther PNT-C.mtf	MM
Panther PNT-CA.mtf	MM
Panther PNT-GBD.mtf	MWL
Panther.blk	MWL
Panzer IX.blk	MWL
Panzer X (X6).blk	MWL
Panzer X (XB).blk	MWL
Panzer X.blk	MWL
Panzerfaust (Wirbelwind).blk	MWL
Panzerfaust.blk	MWL
Paramour Mobile Repair Vehicle (MFB).blk	MM
Paramour Mobile Repair Vehicle (Standard).blk	MM
Parash 2.mtf	MM
Parash.mtf	MM
Pariah (Septicemia) A-Z.mtf	MM
Pariah (Septicemia) B-Z.mtf	MM
Pariah (Septicemia) C-Z.mtf	MM
Pariah (Septicemia) D-Z.mtf	MM
Pariah (Septicemia) E.mtf	MM
Pariah (Septicemia) F.mtf	MM
Pariah (Septicemia) US.mtf	MM
Pariah (Septicemia) UW.mtf	MM
Pariah (Septicemia) Z.mtf	MM
Pariah A.mtf	MM
Pariah B.mtf	MM
Pariah C.mtf	MM
Pariah D.mtf	MM
Pariah Prime.mtf	MM
Partisan AA Vehicle (3134 Upgrade).blk	MM
Partisan AA Vehicle (Standard).blk	MM
Partisan Air Defense Tank (Cell).blk	MM
Partisan Air Defense Tank (Company Command).blk	MM
Partisan Air Defense Tank (Lance Command).blk	MM
Partisan Air Defense Tank (LRM).blk	MM
Partisan Air Defense Tank (Quad RAC).blk	MM
Partisan Air Defense Tank (Quad RAC2).blk	MWL
Partisan Air Defense Tank (RAC).blk	MM
Partisan Air Defense Tank (XL).blk	MM
Partisan Air Defense Tank.blk	MM
Partisan Heavy Tank (AC2).blk	MM
Partisan Heavy Tank (C3).blk	MM
Partisan Heavy Tank (C3S).blk	MWL
Partisan Heavy Tank (LAC5).blk	MWL
Partisan Heavy Tank (LBX-5).blk	MWL
Partisan Heavy Tank (LRM).blk	MM
Partisan Heavy Tank.blk	MM
Partisan Hull Defense.blk	MM
Partisan Partisan Heavy Tank (C3S).blk	MM
Pathfinder PFF-2.mtf	MM
Pathfinder PFF-2T.mtf	MM
Patriot PKM-2C.mtf	MM
Patriot PKM-2D.mtf	MM
Patriot PKM-2E.mtf	MM
Patriot PKM-2T.mtf	MWL
Patriot PKM-3M.mtf	MWL
Patron LoaderMech .mtf	MM
Patron MilitiaMech PTN-2.mtf	MM
Patron MilitiaMech PTN-2M.mtf	MM
Patron-I LoaderMech .mtf	MM
Patton Tank (Ultra).blk	MM
Patton Tank (Upgrade).blk	MWL
Patton Tank SB.blk	MM
Patton Tank.blk	MM
Peacekeeper PKP-1A.mtf	MM
Peacekeeper PKP-1B.mtf	MM
Peacekeeper PKP-2K.mtf	MM
Peacemaker PoliceMech PM6.mtf	MM
Pegasus Scout Hover Tank (3058 Upgrade).blk	MM
Pegasus Scout Hover Tank (C3 master).blk	MWL
Pegasus Scout Hover Tank (C3 reactive).blk	MWL
Pegasus Scout Hover Tank (C3).blk	MM
Pegasus Scout Hover Tank (Intruder).blk	MWL
Pegasus Scout Hover Tank (Missile).blk	MWL
Pegasus Scout Hover Tank (MRM).blk	MM
Pegasus Scout Hover Tank (Sealed).blk	MM
Pegasus Scout Hover Tank (Sensors).blk	MWL
Pegasus Scout Hover Tank (Unarmed).blk	MWL
Pegasus Scout Hover Tank X.blk	MM
Pegasus Scout Hover Tank X-Pulse.blk	MM
Pegasus Scout Hover Tank.blk	MWL
Pegasus Scout Hovertank (Missile).blk	MM
Pegasus Scout Hovertank (Sensors).blk	MM
Pegasus Scout Hovertank (Unarmed).blk	MM
Pegasus Scout Hovertank.blk	MM
Pendragon PDG-1R.mtf	MM
Pendragon PDG-1X MUSE RED.mtf	MM
Penetrator PTR-4D.mtf	MM
Penetrator PTR-4DX.mtf	MWL
Penetrator PTR-4F.mtf	MM
Penetrator PTR-6M.mtf	MM
Penetrator PTR-6S.mtf	MM
Penetrator PTR-6T.mtf	MM
Penetrator PTR-8S.mtf	MWL
Penthesilea PEN-2H.mtf	MM
Penthesilea PEN-2MAF.mtf	MM
Percival (Type S).blk	MWL
Percival.blk	MWL
Peregrine (Horned Owl) 2.mtf	MM
Peregrine (Horned Owl) 3.mtf	MM
Peregrine (Horned Owl) 4.mtf	MM
Peregrine (Horned Owl) 5.mtf	MM
Peregrine (Horned Owl).mtf	MM
Peregrine Attack VTOL (Cargo).blk	MM
Peregrine Attack VTOL (Kurita).blk	MM
Peregrine Attack VTOL.blk	MM
Perseus P1 A.mtf	MM
Perseus P1 B.mtf	MM
Perseus P1 C.mtf	MM
Perseus P1 D.mtf	MM
Perseus P1 F.mtf	MWL
Perseus P1 Prime.mtf	MM
Perseus P1E.mtf	MM
Perseus P1G.mtf	MWL
Perseus P1H.mtf	MWL
Perseus P1P.mtf	MM
Perseus P1W.mtf	MM
Pershing.blk	MWL
Phalanx (A).blk	MM
Phalanx (B).blk	MM
Phalanx (C).blk	MM
Phalanx (D).blk	MM
Phalanx (WoB-A).blk	MM
Phalanx (WoB-B).blk	MM
Phalanx (WoB-C).blk	MM
Phalanx Support Tank (Production).blk	MM
Phalanx Support Tank (Prototype).blk	MM
Phalanx Support Tank .blk	MWL
Phantom A.mtf	MM
Phantom B.mtf	MM
Phantom C.mtf	MM
Phantom D.mtf	MM
Phantom E.mtf	MM
Phantom F.mtf	MM
Phantom H.mtf	MM
Phantom Prime.mtf	MM
Phoenix Hawk IIC .mtf	MM
Phoenix Hawk IIC 2.mtf	MM
Phoenix Hawk IIC 3.mtf	MM
Phoenix Hawk IIC 4.mtf	MM
Phoenix Hawk IIC 5.mtf	MM
Phoenix Hawk IIC 6.mtf	MM
Phoenix Hawk IIC 7.mtf	MM
Phoenix Hawk IIC 8.mtf	MM
Phoenix Hawk L PXH-11K.mtf	MM
Phoenix Hawk L PXH-11K2.mtf	MM
Phoenix Hawk LAM Mk I PHX-HK1.mtf	MM
Phoenix Hawk LAM Mk I PHX-HK1R.mtf	MM
Phoenix Hawk LAM PHX-HK1RB.mtf	MM
Phoenix Hawk LAM PHX-HK2.mtf	MM
Phoenix Hawk LAM PHX-HK2M.mtf	MM
Phoenix Hawk PHK-2K.mtf	MWL
Phoenix Hawk PHX-6L.mtf	MWL
Phoenix Hawk PXH-1.mtf	MM
Phoenix Hawk PXH-1b.mtf	MM
Phoenix Hawk PXH-1c.mtf	MM
Phoenix Hawk PXH-1D.mtf	MM
Phoenix Hawk PXH-1K.mtf	MM
Phoenix Hawk PXH-1Kk.mtf	MM
Phoenix Hawk PXH-2.mtf	MM
Phoenix Hawk PXH-3D.mtf	MM
Phoenix Hawk PXH-3K.mtf	MM
Phoenix Hawk PXH-3M Masters.mtf	MM
Phoenix Hawk PXH-3M.mtf	MM
Phoenix Hawk PXH-3PL.mtf	MM
Phoenix Hawk PXH-3S.mtf	MM
Phoenix Hawk PXH-4L Sante.mtf	MM
Phoenix Hawk PXH-4L.mtf	MM
Phoenix Hawk PXH-4W.mtf	MM
Phoenix Hawk PXH-5L.mtf	MM
Phoenix Hawk PXH-5W.mtf	MWL
Phoenix Hawk PXH-6D.mtf	MM
Phoenix Hawk PXH-7CS.mtf	MM
Phoenix Hawk PXH-7K.mtf	MM
Phoenix Hawk PXH-7S.mtf	MM
Phoenix Hawk PXH-8CS.mtf	MM
Phoenix PX-1R.mtf	MM
Phoenix PX-3R.mtf	MM
Phoenix PX-4R.mtf	MM
Pike Support Vehicle (3063).blk	MWL
Pike Support Vehicle (AC5).blk	MM
Pike Support Vehicle (Clan).blk	MM
Pike Support Vehicle (Missile).blk	MM
Pike Support Vehicle (RAC) Assault Pike.blk	MM
Pike Support Vehicle (RAC).blk	MWL
Pike Support Vehicle.blk	MM
Pillager Anvil.mtf	MWL
Pillager PLG-1N.mtf	MM
Pillager PLG-3RK.mtf	MWL
Pillager PLG-3Z.mtf	MM
Pillager PLG-4x Anvil.mtf	MM
Pillager PLG-4Z.mtf	MM
Pillager PLG-4ZS Werewolf Hunter.mtf	MWL
Pillager PLG-5L.mtf	MM
Pillager PLG-5Z.mtf	MM
Pillager PLG-5Z2.mtf	MWL
Pillager PLZ-5D.mtf	MWL
Pilum Heavy Tank (Arrow IV).blk	MM
Pilum Heavy Tank.blk	MM
Pinion 2.mtf	MM
Pinion 3.mtf	MM
Pinion 5.mtf	MWL
Pinion.mtf	MM
Pinto Attack VTOL (WoB).blk	MM
Pinto Attack VTOL.blk	MM
Piranha .mtf	MM
Piranha 2.mtf	MM
Piranha 3.mtf	MM
Piranha 4.mtf	MM
Pixiu Heavy Tank (Standard).blk	MM
Plainsman Medium Hovertank (Scout).blk	MM
Plainsman Medium Hovertank (Sealed).blk	MM
Plainsman Medium Hovertank (SSRM).blk	MM
Plainsman Medium Hovertank.blk	MM
Po Heavy Tank (Clan RA).blk	MWL
Po Heavy Tank (LB-X).blk	MM
Po Heavy Tank (LBX).blk	MWL
Po Heavy Tank (Light Gauss).blk	MM
Po Heavy Tank (OD).blk	MWL
Po Heavy Tank (Ultra).blk	MWL
Po Heavy Tank HV Prototype.blk	MM
Po Heavy Tank HV.blk	MM
Po Heavy Tank HVAC.blk	MWL
Po Heavy Tank.blk	MM
Po II Heavy Tank (Arrow IV).blk	MM
Po II Heavy Tank (Gauss).blk	MM
Po II Heavy Tank (Stealth).blk	MM
Po II Heavy Tank.blk	MM
Poignard PGD-L3.blk	MWL
Poignard PGD-R3.blk	MWL
Poignard PGD-Y3.blk	MWL
Pollaxe PLX-1A.mtf	MWL
Pollux ADA Heavy Tank.blk	MM
Pompier GM-3A.mtf	MM
Porcupine PRC-1N.mtf	MM
Porcupine PRC-2N.mtf	MM
Poseidon PSD-V2.mtf	MM
Pouncer A.mtf	MM
Pouncer B.mtf	MM
Pouncer C.mtf	MM
Pouncer D.mtf	MM
Pouncer E.mtf	MM
Pouncer F.mtf	MM
Pouncer H.mtf	MM
Pouncer Prime.mtf	MM
Pouncer S.mtf	MWL
PowerLoader Exoskeleton P-5000.blk	MM
Powerman LoaderMech SC XI (Laser).mtf	MM
Powerman LoaderMech SC XI (SRM).mtf	MM
Powerman LoaderMech SC XI.mtf	MM
Powerman XV LoaderMech (Standard).mtf	MM
Powerman XVI LoaderMech (Standard).mtf	MM
Praetorian Mobile Strategic Command HQ (Standard).blk	MM
Praetorian PRN4-A.mtf	MWL
Praetorian PRN4-AP.mtf	MWL
Predator .mtf	MM
Predator 2.mtf	MM
Predator Tank Destroyer (Original).blk	MM
Predator Tank Destroyer (Standard).blk	MM
Prefect PRF-1R Veronica.mtf	MM
Prefect PRF-1R.mtf	MM
Prefect PRF-2R.mtf	MM
Prefect PRF-3R.mtf	MM
Preta C-PRT-O Asmodaeus.mtf	MWL
Preta C-PRT-O Caelestis.mtf	MWL
Preta C-PRT-O Comminus.mtf	MWL
Preta C-PRT-O Dominus.mtf	MWL
Preta C-PRT-O Eminus II.mtf	MWL
Preta C-PRT-O Eminus III.mtf	MWL
Preta C-PRT-O Eminus.mtf	MWL
Preta C-PRT-O Exanimus.mtf	MWL
Preta C-PRT-O Infernus.mtf	MWL
Preta C-PRT-O Invictus.mtf	MM
Preta C-PRT-O Invictus.mtf	MWL
Preta C-PRT-O Kendali.mtf	MM
Preta C-PRT-O Luminos.mtf	MWL
Preta C-PRT-OA Dominus.mtf	MM
Preta C-PRT-OB Infernus.mtf	MM
Preta C-PRT-OC Comminus.mtf	MM
Preta C-PRT-OD Luminos.mtf	MM
Preta C-PRT-OE Eminus.mtf	MM
Preta C-PRT-OS Caelestis.mtf	MM
Preta C-PRT-OU Exanimus.mtf	MM
Prey Seeker PY-SR10.mtf	MM
Privateer PV-1K.mtf	MWL
Privateer PV-2K.mtf	MWL
Privateer PV-2L.mtf	MWL
Privateer PV-3L.mtf	MWL
Privateer PV-4K.mtf	MWL
Prometheus Combat Support Bridgelayer .blk	MM
Prometheus.mtf	MM
Prowler Multi-Terrain Vehicle (3140 Upgrade).blk	MM
Prowler Multi-Terrain Vehicle (Davion).blk	MWL
Prowler Multi-Terrain Vehicle (ECM).blk	MM
Prowler Multi-Terrain Vehicle (FWLM).blk	MWL
Prowler Multi-Terrain Vehicle (Kurita).blk	MWL
Prowler Multi-Terrain Vehicle (LAAF).blk	MWL
Prowler Multi-Terrain Vehicle (RAF).blk	MM
Prowler Multi-Terrain Vehicle (Sealed).blk	MM
Prowler Multi-Terrain Vehicle (Security).blk	MM
Prowler Multi-Terrain Vehicle (Succession Wars).blk	MM
Prowler Multi-Terrain Vehicle (Support).blk	MM
Prowler Multi-Terrain Vehicle (Terra).blk	MWL
Prowler Multi-Terrain Vehicle (WoB).blk	MM
Prowler Multi-Terrain Vehicle.blk	MM
Prowler PWR-1X.mtf	MM
Prowler PWR-1X1.mtf	MM
Pulverizer PUL-2V.mtf	MM
Puma (Adder)  Prime.mtf	MM
Puma (Adder) A.mtf	MM
Puma (Adder) B.mtf	MM
Puma (Adder) C.mtf	MM
Puma (Adder) D.mtf	MM
Puma (Adder) E.mtf	MM
Puma (Adder) H.mtf	MM
Puma (Adder) J.mtf	MM
Puma (Royal).blk	MWL
Puma Assault Tank PAT-001.blk	MM
Puma Assault Tank PAT-002.blk	MM
Puma Assault Tank PAT-005.blk	MM
Puma Assault Tank PAT-005b.blk	MM
Puma Assault Tank PAT-007.blk	MM
Puma Assault Tank PAT-008.blk	MM
Purifier Adaptive Battle Armor [Laser] (RAF).blk	MM
Purifier Adaptive Battle Armor [Laser].blk	MM
Purifier Adaptive Battle Armor [Narc] (RAF).blk	MM
Purifier Adaptive Battle Armor [Narc].blk	MM
Purifier Adaptive Battle Armor [PPC] (RAF).blk	MM
Purifier Adaptive Battle Armor [PPC].blk	MM
Purifier Adaptive Battle Armor [TAG] (RAF).blk	MM
Purifier Adaptive Battle Armor [TAG].blk	MM
Purifier BA Terra AP Gauss(C).blk	MM
Purifier BA Terra ER Small(C).blk	MM
Purifier BA Terra Recoilless Rifle(C).blk	MM
Purifier BA Terra Small Pulse(C).blk	MM
Pwwka S-PW-1LAM.mtf	MM
Quasimodo QSM-3D.mtf	MM
Quasit MilitiaMech QUA-51M.mtf	MM
Quasit MilitiaMech QUA-51P.mtf	MM
Quasit Militiamech QUA-51T.mtf	MM
Quiang-Ton (Export).blk	MWL
Quiang-Ton (Jui-Jie-Bian).blk	MWL
Quiang-Ton.blk	MWL
Quickdraw QKD-4G.mtf	MM
Quickdraw QKD-4H.mtf	MM
Quickdraw QKD-5A.mtf	MM
Quickdraw QKD-5K.mtf	MM
Quickdraw QKD-5K2.mtf	MM
Quickdraw QKD-5M.mtf	MM
Quickdraw QKD-5Mr.mtf	MM
Quickdraw QKD-5MS.mtf	MWL
Quickdraw QKD-5Sb.mtf	MWL
Quickdraw QKD-6VS.mtf	MWL
Quickdraw QKD-8K.mtf	MM
Quickdraw QKD-8P.mtf	MM
Quickdraw QKD-8X.mtf	MM
Quickdraw QKD-9M.mtf	MM
Quickdraw QKD-9W.mtf	MWL
Quickdraw QKD-C.mtf	MM
Quirinus BattleArmor (David LGR).blk	MM
Quirinus BattleArmor (Grenade Launcher).blk	MM
Quirinus BattleArmor (MG).blk	MM
R10 Mechanized ICV (A).blk	MM
R10 Mechanized ICV (B).blk	MM
R10 Mechanized ICV (Coolant Truck).blk	MM
R10 Mechanized ICV (Prime).blk	MM
Rabid Coyote 2.mtf	MM
Rabid Coyote.mtf	MM
Raiden Battle Armor (Anti-Infantry).blk	MM
Raiden Battle Armor (Original).blk	MM
Raiden Battle Armor [Flamer].blk	MM
Raiden Battle Armor [Laser].blk	MM
Raiden Battle Armor [MG].blk	MM
Raiden Battle Armor [MRM].blk	MM
Raiden Battle Armor [Tsunami].blk	MM
Raiden Battle Armor II (Flamer).blk	MM
Raiden Battle Armor II (HMG).blk	MM
Raider JL-1.mtf	MM
Raider Mk II JL-2.mtf	MM
Raijin II RJN-200-A.mtf	MM
Raijin II RJN-200-A2.mtf	MWL
Raijin II RJN-200-B.mtf	MM
Raijin II RJN-200-C.mtf	MM
Raijin RJN101-A.mtf	MM
Raijin RJN101-C.mtf	MM
Rakshasa MDG-1A.mtf	MM
Rakshasa MDG-1Ar.mtf	MM
Rakshasa MDG-1B.mtf	MM
Rakshasa MDG-2A.mtf	MM
Rakshasa MDG-SS.mtf	MWL
Rampage RMP-2G.mtf	MM
Rampage RMP-4G Benboudaoud.mtf	MM
Rampage RMP-4G.mtf	MM
Rampage RMP-5G.mtf	MM
Randolph Support Vehicle.blk	MM
Ranger Armored Fighting Vehicle VV1 (Interdictor).blk	MM
Ranger Armored Fighting Vehicle VV1 (MG).blk	MM
Ranger Armored Fighting Vehicle VV1.blk	MM
Ranger Armored Fighting Vehicle VV2.blk	MM
Ranger Armored Fighting Vehicle VV22.blk	MM
Rapier RPR-100.blk	MWL
Rapier RPR-100b.blk	MWL
Rapier RPR-101.blk	MWL
Rapier RPR-102.blk	MWL
Rapier RPR-200.blk	MWL
Rapier RPR-300.blk	MWL
Raptor II RPT-2X.mtf	MM
Raptor II RPT-2X1.mtf	MM
Raptor II RPT-2X2.mtf	MM
Raptor II RPT-3X.mtf	MM
Raptor II RPT-5X.mtf	MM
Raptor RTX1-O.mtf	MM
Raptor RTX1-OA.mtf	MM
Raptor RTX1-OB.mtf	MM
Raptor RTX1-OC.mtf	MM
Raptor RTX1-OD.mtf	MM
Raptor RTX1-OE.mtf	MM
Raptor RTX1-OF.mtf	MM
Raptor RTX1-OG.mtf	MM
Raptor RTX1-OR.mtf	MM
Raptor RTX1-OU.mtf	MM
Ravager Assault Battle Armor (Level I) .blk	MM
Ravager Assault Battle Armor (LRM MH).blk	MM
Ravager Assault Battle Armor (LRM).blk	MM
Ravager Assault Battle Armor (MH).blk	MM
Ravager Assault Battle Armor.blk	MM
Raven II RVN-5X.mtf	MM
Raven RVN-1X.mtf	MM
Raven RVN-2X.mtf	MM
Raven RVN-3L.mtf	MM
Raven RVN-3M.mtf	MM
Raven RVN-3X.mtf	MM
Raven RVN-4L.mtf	MM
Raven RVN-4LC.mtf	MM
Raven RVN-4Lr.mtf	MM
Raven RVN-4X.mtf	MM
Raven RVN-5L.mtf	MWL
Raven RVN-5LV.mtf	MWL
Raven RVN-5LX.mtf	MWL
Raven RVN-SR.mtf	MM
Raven RVN-SS.mtf	MM
Raven X RVN-3X.mtf	MM
Raven X.mtf	MWL
Razorback RZK-10S.mtf	MM
Razorback RZK-10T.mtf	MM
Razorback RZK-9S.mtf	MM
Razorback RZK-9T.mtf	MM
README.md	MM
Red Kite Attack VTOL (Standard).blk	MM
Red Shift RDS-2A.mtf	MM
Red Shift RDS-2B.mtf	MM
Red Shift RDS-3A.mtf	MM
Regulator Hovertank (Alan).blk	MWL
Regulator Hovertank (Arrow IV).blk	MM
Regulator Hovertank (RAC).blk	MM
Regulator Hovertank Alan.blk	MM
Regulator Hovertank.blk	MM
Regulator II Hovertank (RAC).blk	MM
Regulator II Hovertank (Stealth).blk	MM
Regulator II Hovertank.blk	MM
Reptar MilitiaMech EPT-C-1.mtf	MM
Resgate PA(L) (Standard).blk	MM
Revenant (Bis).blk	MWL
Revenant (Cell).blk	MWL
Revenant.blk	MWL
Rhino Fire Support Tank (CS-RK).blk	MWL
Rhino Fire Support Tank (Flamer).blk	MM
Rhino Fire Support Tank (Hagar).blk	MM
Rhino Fire Support Tank (MG).blk	MM
Rhino Fire Support Tank (ML).blk	MM
Rhino Fire Support Tank (Royal).blk	MM
Rhino Fire Support Tank (SL).blk	MM
Rhino Fire Support Tank (WoB).blk	MWL
Rhino Fire Support Tank.blk	MM
Rhino.blk	MWL
Riever F-100.blk	MWL
Riever F-100a.blk	MWL
Riever F-100b.blk	MWL
Riever F-700.blk	MWL
Riever F-700a.blk	MWL
Riever F-700b.blk	MWL
Rifleman C 2.mtf	MM
Rifleman C.mtf	MM
Rifleman II RFL-3N-2 Kataga.mtf	MM
Rifleman II RFL-3N-2.mtf	MM
Rifleman II RFL-3N-2CS.mtf	MWL
Rifleman II RFL-3N-CS3.mtf	MWL
Rifleman IIC .mtf	MM
Rifleman IIC 2.mtf	MM
Rifleman IIC 3.mtf	MM
Rifleman IIC 4.mtf	MM
Rifleman IIC 5.mtf	MM
Rifleman IIC 6.mtf	MM
Rifleman IIC 7.mtf	MM
Rifleman IIC 8.mtf	MM
Rifleman III RF2-A.mtf	MM
Rifleman RFL-3C.mtf	MM
Rifleman RFL-3Cr.mtf	MM
Rifleman RFL-3N.mtf	MM
Rifleman RFL-4D.mtf	MM
Rifleman RFL-4K.mtf	MWL
Rifleman RFL-4N.mtf	MWL
Rifleman RFL-5D.mtf	MM
Rifleman RFL-5M.mtf	MM
Rifleman RFL-5R.mtf	MWL
Rifleman RFL-5S.mtf	MWL
Rifleman RFL-6D.mtf	MM
Rifleman RFL-6M.mtf	MWL
Rifleman RFL-6X.mtf	MM
Rifleman RFL-6XE.mtf	MWL
Rifleman RFL-7M.mtf	MM
Rifleman RFL-7X.mtf	MM
Rifleman RFL-8D.mtf	MM
Rifleman RFL-8M.mtf	MWL
Rifleman RFL-8X.mtf	MM
Rifleman RFL-9T.mtf	MM
Rifleman RFL-9X.mtf	MWL
Rifleman RFL-JF.mtf	MWL
Rifleman RFL-X3 MUSE WIND.mtf	MM
Ripper Infantry Transport (ERML).blk	MM
Ripper Infantry Transport (Infantry).blk	MM
Ripper Infantry Transport (LPPC).blk	MM
Ripper Infantry Transport (MG).blk	MM
Ripper Infantry Transport (Royal).blk	MM
Ripper Infantry Transport (SPL).blk	MM
Ripper Infantry Transport.blk	MM
Rock Hound ProspectorMech AM-PRM-RH7 Rock Possum.mtf	MM
Rock Hound ProspectorMech AM-PRM-RH7.mtf	MM
Rock Hound ProspectorMech AM-PRM-RH7A Rock Otter.mtf	MM
Rogue Bear Elite.blk	MWL
Rogue Bear Heavy Battle Armor (Upgrade).blk	MM
Rogue Bear Heavy Battle Armor HR.blk	MM
Rogue Bear Heavy Battle Armor Hybrid.blk	MM
Rogue Bear Heavy Battle Armor.blk	MM
Rogue RGU-133E.blk	MWL
Rogue RGU-133Eb.blk	MWL
Rogue RGU-133F.blk	MWL
Rogue RGU-133L.blk	MWL
Rogue RGU-133LP.blk	MWL
Rogue RGU-133P.blk	MWL
Rokurokubi RK-4K.mtf	MM
Rokurokubi RK-4T.mtf	MM
Rokurokubi RK-4X.mtf	MM
Roland (A).blk	MWL
Roland (B).blk	MWL
Roland (C).blk	MWL
Roland (Prime).blk	MWL
Rommel Tank (Clan).blk	MWL
Rommel Tank (Gauss).blk	MM
Rommel Tank (Howitzer) Production.blk	MM
Rommel Tank (Howitzer) Prototype.blk	MM
Rommel Tank (Sealed).blk	MM
Rommel Tank.blk	MM
Ronin SA-RN.mtf	MM
Ronin SA-RN7.mtf	MM
Rook NH-1A.mtf	MM
Rook NH-1B.mtf	MM
Rook NH-2.mtf	MM
Rook NH-3X.mtf	MM
Rook-X NH-1B.mtf	MM
Rottweiler Battle Armor (Close Combat).blk	MM
Rottweiler Battle Armor (Firedrake).blk	MM
Rottweiler Battle Armor (Upgrade).blk	MM
Rottweiler Battle Armor.blk	MM
Rotunda Scout Vehicle (LRM).blk	MM
Rotunda Scout Vehicle (RL).blk	MM
Rotunda Scout Vehicle (SRM).blk	MM
Rotunda Scout Vehicle.blk	MM
Rusalka S-RSL-0 Comminus.blk	MWL
Rusalka S-RSL-0 Dominus.blk	MWL
Rusalka S-RSL-0 Eminus.blk	MWL
Rusalka S-RSL-0 Infernus.blk	MWL
Rusalka S-RSL-0 Invictus.blk	MWL
Rusalka S-RSL-0 Luminos.blk	MWL
Ryoken (Stormcrow) (Kotare).mtf	MM
Ryoken (Stormcrow) A.mtf	MM
Ryoken (Stormcrow) B.mtf	MM
Ryoken (Stormcrow) BF.mtf	MWL
Ryoken (Stormcrow) BG.mtf	MWL
Ryoken (Stormcrow) BR.mtf	MWL
Ryoken (Stormcrow) BW.mtf	MWL
Ryoken (Stormcrow) C.mtf	MM
Ryoken (Stormcrow) D.mtf	MM
Ryoken (Stormcrow) E.mtf	MM
Ryoken (Stormcrow) F.mtf	MM
Ryoken (Stormcrow) G.mtf	MM
Ryoken (Stormcrow) H.mtf	MM
Ryoken (Stormcrow) I.mtf	MM
Ryoken (Stormcrow) Prime.mtf	MM
Ryoken (Stormcrow) Z.mtf	MM
Ryoken II .mtf	MM
Ryoken II 2.mtf	MM
Ryoken II 3.mtf	MM
Ryoken II Tassa.mtf	MM
S-3 Sai.blk	MWL
S-4 Sai.blk	MWL
S-4C Sai.blk	MWL
S-4X Sai.blk	MWL
S-7 Sai.blk	MWL
S-8 Sai.blk	MWL
Sabaku Kaze Heavy Scout Hover Tank.blk	MM
Saber SB-27.blk	MWL
Saber SB-27b.blk	MWL
Saber SB-28.blk	MWL
Saber SB-29.blk	MWL
Sabra XIII.blk	MWL
Sabre Defense Special.blk	MWL
Sabre SB-27.blk	MWL
Sabre SB-27b.blk	MWL
Sabutai A.blk	MWL
Sabutai B.blk	MWL
Sabutai C.blk	MWL
Sabutai D.blk	MWL
Sabutai J.blk	MWL
Sabutai Prime.blk	MWL
Sagittaire SGT-10X.mtf	MM
Sagittaire SGT-14D.mtf	MM
Sagittaire SGT-8DM.mtf	MWL
Sagittaire SGT-8R.mtf	MM
Sagittaire SGT-8RV.mtf	MWL
Sagittaire SGT-9D.mtf	MM
Sagittarii SGT-2R.blk	MWL
Sagittarii SGT-3R.blk	MWL
Sai S-3.blk	MWL
Sai S-4.blk	MWL
Sai S-4C.blk	MWL
Sai S-4X.blk	MWL
Sai S-7.blk	MWL
Sai S-8.blk	MWL
Saladin Assault Hover Tank (Armor).blk	MM
Saladin Assault Hover Tank (C3).blk	MWL
Saladin Assault Hover Tank (Clan Cargo).blk	MM
Saladin Assault Hover Tank (LB-X).blk	MM
Saladin Assault Hover Tank (LBX).blk	MWL
Saladin Assault Hover Tank (Ultra).blk	MM
Saladin Assault Hover Tank Ifrit.blk	MM
Saladin Assault Hover Tank.blk	MM
Saladin Mk II HCV (BC3).blk	MM
Saladin Mk II HCV (Standard).blk	MM
Salamander (HMG) Elite.blk	MWL
Salamander (Laser) Elite.blk	MWL
Salamander Battle Armor (Anti-Infantry).blk	MM
Salamander Battle Armor (Laser).blk	MM
Salamander Battle Armor.blk	MM
Salamander Elite.blk	MWL
Salamander PPR-5S.mtf	MM
Salamander PPR-5SS.mtf	MWL
Salamander PPR-5T.mtf	MM
Salamander PPR-6S.mtf	MM
Salamander PPR-6T.mtf	MM
Salamander PPR-6TT.mtf	MWL
Salamander PPR-7S.mtf	MM
Salamander PPR-7T.mtf	MM
Salamander PPR-8T.mtf	MWL
Salrilla Exoskeleton PEX-2F.blk	MM
Samurai SL-25.blk	MWL
Samurai SL-26.blk	MWL
Samurai SL-27.blk	MWL
San Ku Chu (Mk I).blk	MWL
San Ku Chu (Mk IB).blk	MWL
San Ku Chu (Mk III).blk	MWL
Sand Devil Hover Tank.blk	MM
Sangine Shrike-Thrush Nanook.blk	MWL
Saracen Medium Hover Tank (C3).blk	MWL
Saracen Medium Hover Tank (MRM).blk	MM
Saracen Medium Hover Tank.blk	MM
Saracen Mk II HCV (BC3).blk	MM
Saracen Mk II HCV (Standard).blk	MM
Sarath SRTH-1O.mtf	MM
Sarath SRTH-1OA.mtf	MM
Sarath SRTH-1OB.mtf	MM
Sarissa MN1-D.mtf	MM
Sarissa SecurityMech MN2-A.mtf	MM
Sarpedon (Glaukos).blk	MWL
Sarpedon (Model A).blk	MWL
Sarpedon.blk	MWL
Sasquatch SQS-TH-001.mtf	MM
Sasquatch SQS-TH-002.mtf	MM
Sasquatch SQS-TH-003.mtf	MM
Savage Coyote A.mtf	MM
Savage Coyote B.mtf	MM
Savage Coyote C.mtf	MM
Savage Coyote J.mtf	MM
Savage Coyote Prime.mtf	MM
Savage Coyote W.mtf	MM
Savage Coyote Z.mtf	MM
Savannah Master Hovercraft (Interdictor).blk	MM
Savannah Master Hovercraft (SL).blk	MM
Savannah Master Hovercraft.blk	MM
Savior Repair Vehicle (Standard).blk	MM
Saxon APC (HQ).blk	MM
Saxon APC (Laser).blk	MM
Saxon APC (MASH).blk	MM
Saxon APC Laser.blk	MWL
Saxon APC.blk	MM
Scapha Hovertank (A).blk	MM
Scapha Hovertank (B).blk	MM
Scapha Hovertank (C).blk	MM
Scapha Hovertank (D).blk	MM
Scapha Hovertank (E).blk	MM
Scapha Hovertank (F).blk	MM
Scapha Hovertank (G).blk	MM
Scapha Hovertank (H).blk	MM
Scapha Hovertank (I).blk	MM
Scapha Hovertank (J).blk	MM
Scapha Hovertank (Primary).blk	MM
Scarabus SCB-9A.mtf	MM
Scarabus SCB-9T.mtf	MM
Scarecrow UCU-F4 Hobbled Scarecrow.mtf	MM
Scarecrow UCU-F4.mtf	MM
Schildkrote Line Tank (HPPC).blk	MM
Schildkrote Line Tank (Standard).blk	MM
Schiltron Mobile Fire-Support Platform A.blk	MM
Schiltron Mobile Fire-Support Platform B.blk	MM
Schiltron Mobile Fire-Support Platform C.blk	MM
Schiltron Mobile Fire-Support Platform D.blk	MM
Schiltron Mobile Fire-Support Platform E.blk	MM
Schiltron Mobile Fire-Support Platform F.blk	MM
Schiltron Mobile Fire-Support Platform Prime.blk	MM
Schrek AC Carrier.blk	MM
Schrek IIX PPC Carrier.blk	MM
Schrek PPC Carrier (Anti-Infantry).blk	MM
Schrek PPC Carrier (Armor).blk	MM
Schrek PPC Carrier (C3M).blk	MM
Schrek PPC Carrier (C3S).blk	MWL
Schrek PPC Carrier.blk	MM
Scimitar Medium Hover Tank (C3 master).blk	MWL
Scimitar Medium Hover Tank (C3).blk	MM
Scimitar Medium Hover Tank (LBX).blk	MWL
Scimitar Medium Hover Tank (Missile).blk	MM
Scimitar Medium Hover Tank (TAG).blk	MM
Scimitar Medium Hover Tank.blk	MM
Scimitar Mk II HCV (3136 Upgrade).blk	MM
Scimitar Mk II HCV (BC3).blk	MM
Scimitar Mk II HCV (Standard).blk	MM
Scimitar Mk II Hover Combat Vehicle.blk	MWL
Scorpion II SCR-3K.mtf	MWL
Scorpion II SCR-4K.mtf	MWL
Scorpion Light Tank (Clan).blk	MWL
Scorpion Light Tank (FC LL).blk	MWL
Scorpion Light Tank (FC RAC).blk	MWL
Scorpion Light Tank (FC UAC).blk	MWL
Scorpion Light Tank (LAC).blk	MM
Scorpion Light Tank (Laser).blk	MWL
Scorpion Light Tank (LBX).blk	MWL
Scorpion Light Tank (LRM).blk	MM
Scorpion Light Tank (ML).blk	MM
Scorpion Light Tank (MRM).blk	MM
Scorpion Light Tank (SRM).blk	MM
Scorpion Light Tank Minesweeper.blk	MM
Scorpion Light Tank.blk	MM
Scorpion SCO-11L.mtf	MWL
Scorpion SCP-10M.mtf	MM
Scorpion SCP-10M-X.mtf	MWL
Scorpion SCP-12C.mtf	MM
Scorpion SCP-12K.mtf	MM
Scorpion SCP-12S.mtf	MM
Scorpion SCP-13W.mtf	MWL
Scorpion SCP-15.mtf	MWL
Scorpion SCP-1N (Wednall).mtf	MM
Scorpion SCP-1N.mtf	MM
Scorpion SCP-1O.mtf	MM
Scorpion SCP-1TB.mtf	MM
Scorpion SCP-2O.mtf	MWL
Scorpion SCP-4M.mtf	MWL
Scourge SCG-WD1.mtf	MM
Scourge SCG-WF1.mtf	MM
Scylla 2.mtf	MM
Scylla 3.mtf	MM
Scylla.mtf	MM
Scytha A.blk	MWL
Scytha B.blk	MWL
Scytha C.blk	MWL
Scytha D.blk	MWL
Scytha J.blk	MWL
Scytha K.blk	MWL
Scytha Prime.blk	MWL
Sea Fox Amphibious Armor.blk	MM
Sea Hunter Maritime Tank .blk	MM
Sea Skimmer Hydrofoil (SRM2).blk	MM
Sea Skimmer Hydrofoil (SRM6).blk	MM
Sea Skimmer Hydrofoil ELRM.blk	MM
Sea Skimmer Hydrofoil Sniper.blk	MM
Sea Skimmer Hydrofoil.blk	MM
Se'irim Medium Battle Armor (Anti Infantry).blk	MM
Se'irim Medium Battle Armor (Capture Team).blk	MM
Se'irim Medium Battle Armor.blk	MM
Sekhmet Assault Vehicle (Standard).blk	MM
Sentinel IIC.mtf	MWL
Sentinel STN-1S.mtf	MM
Sentinel STN-3CS.mtf	MWL
Sentinel STN-3K.mtf	MM
Sentinel STN-3KA.mtf	MM
Sentinel STN-3KB.mtf	MM
Sentinel STN-3L.mtf	MM
Sentinel STN-3Lb.mtf	MM
Sentinel STN-3M.mtf	MM
Sentinel STN-3RK.mtf	MWL
Sentinel STN-3W.mtf	MWL
Sentinel STN-4D.mtf	MM
Sentinel STN-4K.mtf	MWL
Sentinel STN-5D.mtf	MWL
Sentinel STN-5WB.mtf	MM
Sentinel STN-6EX.mtf	MWL
Sentinel STN-6K.mtf	MWL
Sentinel STN-7K.mtf	MWL
Sentinel STN-C.mtf	MM
Sentry SNT-04.mtf	MM
Sentry SNT-1D.mtf	MWL
Sentry SNT-W5.mtf	MM
Seraph C-SRP-O Caelestis.mtf	MM
Seraph C-SRP-O Comminus.mtf	MWL
Seraph C-SRP-O Dominus.mtf	MWL
Seraph C-SRP-O Eminus.mtf	MWL
Seraph C-SRP-O Havalah.mtf	MM
Seraph C-SRP-O Infernus.mtf	MWL
Seraph C-SRP-O Invictus.mtf	MM
Seraph C-SRP-O Invictus.mtf	MWL
Seraph C-SRP-O Israfil.mtf	MWL
Seraph C-SRP-O Luminos.mtf	MWL
Seraph C-SRP-O Maion.mtf	MWL
Seraph C-SRP-O Raguel.mtf	MWL
Seraph C-SRP-O Ramiel.mtf	MWL
Seraph C-SRP-O Ravana.mtf	MM
Seraph C-SRP-OA Dominus.mtf	MM
Seraph C-SRP-OB Infernus.mtf	MM
Seraph C-SRP-OC Comminus.mtf	MM
Seraph C-SRP-OD Luminos.mtf	MM
Seraph C-SRP-OE Eminus.mtf	MM
Seydiltz SYD Z1.blk	MWL
Seydiltz SYD-Z2.blk	MWL
Seydiltz SYD-Z2A.blk	MWL
Seydiltz SYD-Z2B-Dev.blk	MWL
Seydiltz SYD-Z3.blk	MWL
Seydiltz SYD-Z3A.blk	MWL
Seydiltz SYD-Z4.blk	MWL
Seydlitz SYD-21.blk	MWL
Seydlitz SYD-Z1.blk	MWL
Seydlitz SYD-Z2.blk	MWL
Seydlitz SYD-Z2A.blk	MWL
Seydlitz SYD-Z2B.blk	MWL
Seydlitz SYD-Z3.blk	MWL
Seydlitz SYD-Z3A.blk	MWL
Seydlitz SYD-Z4.blk	MWL
Sha Yu SYU-2B.mtf	MM
Sha Yu SYU-4B.mtf	MM
Sha Yu SYU-6B.mtf	MM
Sha Yu SYU-8B.mtf	MWL
Shackleton AESV .blk	MM
Shade S-HA-0 Comminus.blk	MWL
Shade S-HA-0 Dominus.blk	MWL
Shade S-HA-0 Eminus.blk	MWL
Shade S-HA-0 Infernus.blk	MWL
Shade S-HA-0 Invictus.blk	MWL
Shade S-HA-0 Luminos.blk	MWL
Shadow Cat A.mtf	MM
Shadow Cat B.mtf	MM
Shadow Cat C.mtf	MM
Shadow Cat E.mtf	MM
Shadow Cat F.mtf	MM
Shadow Cat G.mtf	MWL
Shadow Cat H.mtf	MM
Shadow Cat II .mtf	MM
Shadow Cat II 2.mtf	MM
Shadow Cat II 3.mtf	MM
Shadow Cat II 4.mtf	MM
Shadow Cat J.mtf	MM
Shadow Cat Prime.mtf	MM
Shadow Hawk C.mtf	MM
Shadow Hawk IIC .mtf	MM
Shadow Hawk IIC 2.mtf	MM
Shadow Hawk IIC 3.mtf	MM
Shadow Hawk IIC 4.mtf	MM
Shadow Hawk IIC 5.mtf	MM
Shadow Hawk IIC 6.mtf	MM
Shadow Hawk IIC 7.mtf	MM
Shadow Hawk IIC 8.mtf	MM
Shadow Hawk IIC 9.mtf	MM
Shadow Hawk SHD-10M.mtf	MWL
Shadow Hawk SHD-11CS.mtf	MM
Shadow Hawk SHD-11CZ.mtf	MWL
Shadow Hawk SHD-11M.mtf	MWL
Shadow Hawk SHD-12C.mtf	MM
Shadow Hawk SHD-1R.mtf	MM
Shadow Hawk SHD-2D.mtf	MM
Shadow Hawk SHD-2D2.mtf	MM
Shadow Hawk SHD-2H.mtf	MM
Shadow Hawk SHD-2Hb.mtf	MM
Shadow Hawk SHD-2K.mtf	MM
Shadow Hawk SHD-3K.mtf	MM
Shadow Hawk SHD-5D (Sandy).mtf	MM
Shadow Hawk SHD-5D.mtf	MM
Shadow Hawk SHD-5M.mtf	MM
Shadow Hawk SHD-5MC.mtf	MWL
Shadow Hawk SHD-7CS.mtf	MM
Shadow Hawk SHD-7DM.mtf	MWL
Shadow Hawk SHD-7M.mtf	MM
Shadow Hawk SHD-7Mc.mtf	MWL
Shadow Hawk SHD-7M-X.mtf	MWL
Shadow Hawk SHD-8L.mtf	MM
Shadow Hawk SHD-8M.mtf	MWL
Shadow Hawk SHD-9D.mtf	MM
Shadow Hawk SHD-X1.mtf	MM
Shadow Hawk SHD-X2.mtf	MM
Shamash Reconnaissance Vehicle (Flamer).blk	MM
Shamash Reconnaissance Vehicle (Interdictor).blk	MM
Shamash Reconnaissance Vehicle.blk	MM
Shandra Advanced Scout Vehicle (Original).blk	MM
Shandra Advanced Scout Vehicle (Standard).blk	MM
Shandra Advanced Scout Vehicle.blk	MWL
Shedu Assault Battle Armor (Capture Team).blk	MM
Shedu Assault Battle Armor (PPC).blk	MM
Shedu Assault Battle Armor (Recon).blk	MM
Shedu Assault Battle Armor (Support).blk	MM
Shedu Assault Battle Armor.blk	MM
Shen Long BattleArmor David.blk	MM
Shen Long BattleArmor Interdictor.blk	MM
Shen Long BattleArmor MG.blk	MM
Shen Long BattleArmor MRM.blk	MM
Shen Long BattleArmor Pop Up Mine.blk	MM
Shen Long BattleArmor SRM.blk	MM
Shen Yi SHY-3B.mtf	MM
Shen Yi SHY-5B.mtf	MM
Sher Khan (Apollo).blk	MWL
Sher Khan (CASE).blk	MWL
Sher Khan (Thunderbolt).blk	MWL
Sher Khan (Transport).blk	MWL
Sher Khan.blk	MWL
Sheriff Infantry Support Tank (Standard).blk	MM
Shillelagh Missile Tank (Original).blk	MM
Shillelagh Missile Tank (Standard).blk	MM
Shilone SL-17.blk	MWL
Shilone SL-17AC.blk	MWL
Shilone SL-17R.blk	MWL
Shilone SL-18.blk	MWL
Shiro SH-1V.mtf	MM
Shiro SH-2P.mtf	MM
Shiva SHV-O.blk	MWL
Shiva SHV-OA.blk	MWL
Shiva SHV-OB.blk	MWL
Shiva SHV-OC.blk	MWL
Shiva SHV-S.blk	MWL
Shockwave SKW-2F.mtf	MM
Shockwave SKW-4G.mtf	MM
Shockwave SKW-6H.mtf	MM
Shockwave SKW-8X.mtf	MM
Shoden Assault Vehicle (SSRM).blk	MM
Shoden Assault Vehicle LB-X.blk	MM
Shoden Assault Vehicle.blk	MM
Shogun C.mtf	MM
Shogun SHG-2E.mtf	MM
Shogun SHG-2F (Trisha).mtf	MM
Shogun SHG-2F.mtf	MM
Shogun SHG-2H.mtf	MM
Shogun SHG-2KC.mtf	MWL
Shogun SHG-2WB.mtf	MWL
Shogun SHG-3F.mtf	MWL
Shogun SHG-3HM.mtf	MWL
Shogun SHG-4N.mtf	MWL
Sholagar SL-21.blk	MWL
Sholagar SL-21L.blk	MWL
Sholagar SL-22.blk	MWL
Sholagar SL-27X.blk	MWL
Shootist ST-10S.mtf	MWL
Shootist ST-11C.mtf	MWL
Shootist ST-8A.mtf	MM
Shootist ST-8C.mtf	MM
Shootist ST-9C.mtf	MM
Shootist ST-9E.mtf	MWL
Shrike (Standard).mtf	MM
Shrike 2.mtf	MM
Shrike 3.mtf	MM
Shugenja SJA-7D.mtf	MM
Shugenja SJA-8D.mtf	MWL
Shugenja SJA-8H.mtf	MM
Shun Transport VTOL (Standard).blk	MM
Silver Fox SVR-5X.mtf	MM
Silver Fox SVR-5Y.mtf	MM
Simian BattleArmor (Flamer).blk	MM
Simian BattleArmor (HMG).blk	MM
Simian BattleArmor (LRR).blk	MM
Simian BattleArmor (Small Laser).blk	MM
Sirocco SRC-3C.mtf	MM
Sirocco SRC-4C.mtf	MWL
Sirocco SRC-5C.mtf	MM
Sirocco SRC-6C.mtf	MM
Sirocco SRC-6ME.mtf	MWL
Sirocco SRC-7C.mtf	MWL
Skadi Swift Attack VTOL (Standard).blk	MM
Skanda Light Tank (Standard).blk	MM
Skimmer.blk	MM
Skulker Wheeled Scout Tank (C3M).blk	MM
Skulker Wheeled Scout Tank (MG).blk	MM
Skulker Wheeled Scout Tank (SRM).blk	MM
Skulker Wheeled Scout Tank MK II.blk	MM
Skulker Wheeled Scout Tank X-5.blk	MM
Skulker Wheeled Scout Tank.blk	MM
Skulker X-5.blk	MWL
Slagmaiden SLG-X.mtf	MM
Slayer CX 1.blk	MWL
Slayer SL-15.blk	MWL
Slayer SL-15A.blk	MWL
Slayer SL-15B.blk	MWL
Slayer SL-15C.blk	MWL
Slayer SL-15K.blk	MWL
Slayer SL-15R.blk	MWL
Slayer SL-CX1.blk	MWL
Sling SL-1G.mtf	MM
Sling SL-1H.mtf	MM
Sloth Battle Armor (Hunter).blk	MM
Sloth Battle Armor (Interdictor).blk	MM
Sloth Battle Armor (Interdictor).BLK	MWL
Sloth Battle Armor .blk	MM
Sloth.blk	MWL
SM1 Tank Destroyer Telos.blk	MM
SM1 Tank Destroyer.blk	MM
SM1A Tank Destroyer.blk	MM
SM2 Heavy Artilley Vehicle (LTC).blk	MM
SM2 Heavy Artilley Vehicle (Standard).blk	MM
SM3 Tank Destroyer.blk	MM
Smoothdavid PA(L) II.blk	MM
Smoothgoliath PA(L) II.blk	MM
Snake Alexi.mtf	MM
Snake SNK-1V.mtf	MM
Snake SNK-2B.mtf	MM
Snake SNK-2Br.mtf	MM
Sniper Artillery (Standard).blk	MM
Snow Fox .mtf	MM
Snow Fox 2.mtf	MM
Snow Fox 3.mtf	MM
Snow Fox 4.mtf	MWL
Soarece Super Heavy MBT.blk	MM
Sokar Urban Combat Unit .blk	MM
Sokuryou SKU-181 SurveyMech.mtf	MM
Sokuryou SKU-197 SurveyMech.mtf	MM
Sokuryou SKU-198 SurveyMech.mtf	MM
Solitaire 2.mtf	MM
Solitaire.mtf	MM
Sortek Assault Craft (Interdictor).blk	MM
Sortek Assault Craft (Standard).blk	MM
Space Hound ProspectorMech AM-PRM-SH1.mtf	MM
Spad SPD-502.blk	MWL
Spad SPD-503.blk	MWL
Spad SPD-504.blk	MWL
Sparrowhawk SPR-6D.blk	MWL
Sparrowhawk SPR-7D.blk	MWL
Sparrowhawk SPR-8H.blk	MWL
Sparrowhawk SPR-H5.blk	MWL
Sparrowhawk SPR-H5K.blk	MWL
Sparrowhawk SPR-H8.blk	MWL
Spartan SPT-3W.mtf	MWL
Spartan SPT-5LN.mtf	MWL
Spartan SPT-N1.mtf	MM
Spartan SPT-N2.mtf	MM
Spartan SPT-N3.mtf	MM
Spartan SPT-N4.mtf	MWL
Spartan SPT-NF.mtf	MM
Spatha SP1-X.mtf	MM
Spatha SP2-X Warlord.mtf	MM
Spector SPR-4F.mtf	MM
Spector SPR-5F.mtf	MM
Spector SPR-5H.mtf	MWL
Spector SPR-5S.mtf	MM
Spector SPR-7L.mtf	MWL
Spector SPR-SS.mtf	MWL
Spector SPR-ST.mtf	MM
Spectre Stealth Battle Armor RA.blk	MM
Spectre Stealth Battle Armor.blk	MM
Speeder.blk	MM
Sphinx 2.mtf	MM
Sphinx 3.mtf	MM
Sphinx 4.mtf	MM
Sphinx.mtf	MM
Spider SDR-10K.mtf	MM
Spider SDR-5D.mtf	MM
Spider SDR-5K.mtf	MM
Spider SDR-5V.mtf	MM
Spider SDR-7K.mtf	MM
Spider SDR-7K2.mtf	MM
Spider SDR-7KC.mtf	MM
Spider SDR-7Kr.mtf	MM
Spider SDR-7M.mtf	MM
Spider SDR-8HK.mtf	MWL
Spider SDR-8K.mtf	MM
Spider SDR-8M.mtf	MM
Spider SDR-8R.mtf	MM
Spider SDR-8X.mtf	MM
Spider SDR-8Xr.mtf	MM
Spider SDR-C.mtf	MM
Spindrift Aquatic SecurityMech SDT-1.mtf	MM
Spindrift Aquatic SecurityMech SDT-1A.mtf	MM
Spirit (Hunter).mtf	MWL
Spirit 2.mtf	MM
Spirit.mtf	MM
Sprint Scout Helicopter (C3).blk	MM
Sprint Scout Helicopter (C3i).blk	MM
Sprint Scout Helicopter (Interdictor).blk	MM
Sprint Scout Helicopter (Laser).blk	MM
Sprint Scout Helicopter (Troop Transport).blk	MM
Sprint Scout Helicopter.blk	MM
SRM Carrier (3054 Upgrade).blk	MM
SRM Carrier (C3).blk	MM
SRM Carrier (MRM).blk	MWL
SRM Carrier (WoB).blk	MM
SRM Carrier Primitive.blk	MM
SRM Carrier.blk	MM
Stag II ST-24G.mtf	MM
Stag ST-14G.mtf	MM
Stalker II STK-9A.mtf	MM
Stalker STK-10M.mtf	MWL
Stalker STK-3F (Jamison).mtf	MM
Stalker STK-3F Jagawen.mtf	MM
Stalker STK-3F.mtf	MM
Stalker STK-3Fb.mtf	MM
Stalker STK-3Fk.mtf	MM
Stalker STK-3H.mtf	MM
Stalker STK-3MAF.mtf	MWL
Stalker STK-4N.mtf	MM
Stalker STK-4P.mtf	MM
Stalker STK-5CM.mtf	MWL
Stalker STK-5M.mtf	MM
Stalker STK-5MAF.mtf	MWL
Stalker STK-5S.mtf	MM
Stalker STK-6M.mtf	MM
Stalker STK-6ME.mtf	MWL
Stalker STK-7C3BS.mtf	MM
Stalker STK-7D.mtf	MM
Stalker STK-7M.mtf	MWL
Stalker STK-8M.mtf	MWL
Stalker STK-8S.mtf	MM
Stalking Spider .mtf	MM
Stalking Spider 2.mtf	MM
Stalking Spider 3.mtf	MM
Stalking Spider 3P.mtf	MWL
Stalking Spider II.mtf	MM
Standard (CS-Flamer).blk	MWL
Standard (CS-Laser).blk	MWL
Standard (CS-MG).blk	MWL
Standard (CS-SRM).blk	MWL
Starfire SF-1X.blk	MWL
Starslayer STY-2C.mtf	MM
Starslayer STY-3C.mtf	MM
Starslayer STY-3D.mtf	MM
Starslayer STY-3Dr.mtf	MM
Starslayer STY-3RR.mtf	MWL
Stealth Anna.mtf	MM
Stealth STH-1D.mtf	MM
Stealth STH-2D.mtf	MM
Stealth STH-2D1.mtf	MM
Stealth STH-2D2.mtf	MM
Stealth STH-3S.mtf	MM
Stealth STH-5X.mtf	MM
Stiletto STO-4A.mtf	MM
Stiletto STO-4B.mtf	MM
Stiletto STO-4BS.mtf	MWL
Stiletto STO-4C.mtf	MM
Stiletto STO-6S.mtf	MM
Stiletto STO-6X.mtf	MM
Stinger IIC 2.mtf	MM
Stinger IIC.mtf	MM
Stinger LAM Mk I STG-A1.mtf	MM
Stinger LAM STG-A10.mtf	MM
Stinger LAM STG-A5.mtf	MM
Stinger STG-3G.mtf	MM
Stinger STG-3Gb.mtf	MM
Stinger STG-3P.mtf	MM
Stinger STG-3R.mtf	MM
Stinger STG-4R.mtf	MWL
Stinger STG-4RV.mtf	MWL
Stinger STG-5G.mtf	MM
Stinger STG-5M.mtf	MM
Stinger STG-5R.mtf	MM
Stinger STG-5T.mtf	MM
Stinger STG-6L.mtf	MM
Stinger STG-6P.mtf	MWL
Stinger STG-6S.mtf	MM
Stinger STG-7S.mtf	MM
Stinger STG-RA.mtf	MWL
Stingray (Dirty Dozen).blk	MWL
Stingray (Manta Ray).blk	MWL
Stingray F-90.blk	MWL
Stingray F-90S.blk	MWL
Stingray F-92.blk	MWL
Stingray F-94.blk	MWL
Stingray F-95.blk	MWL
Stingray.blk	MWL
Stoat Scout Car.blk	MM
Stone Rhino 2.mtf	MWL
Stone Rhino.mtf	MWL
Stooping Hawk A.mtf	MM
Stooping Hawk B.mtf	MM
Stooping Hawk C.mtf	MM
Stooping Hawk D.mtf	MM
Stooping Hawk E.mtf	MM
Stooping Hawk F.mtf	MM
Stooping Hawk G.mtf	MM
Stooping Hawk H.mtf	MWL
Stooping Hawk Prime.mtf	MM
Stork Combat Transport .blk	MWL
Storm Raider STM-R1.mtf	MM
Storm Raider STM-R2.mtf	MM
Storm Raider STM-R3.mtf	MM
Storm Raider STM-R4.mtf	MM
Strider SR1-O I.mtf	MWL
Strider SR1-O K.mtf	MWL
Strider SR1-O L.mtf	MWL
Strider SR1-O X2.mtf	MWL
Strider SR1-O X3.mtf	MWL
Strider SR1-O.mtf	MM
Strider SR1-OA.mtf	MM
Strider SR1-OB.mtf	MM
Strider SR1-OC.mtf	MM
Strider SR1-OD.mtf	MM
Strider SR1-OE.mtf	MM
Strider SR1-OF.mtf	MM
Strider SR1-OG.mtf	MM
Strider SR1-OH.mtf	MM
Strider SR1-OM.mtf	MM
Strider SR1-OR.mtf	MM
Strider SR1-OX.mtf	MM
Striga S-STR-0 Comminus.blk	MWL
Striga S-STR-0 Dominus.blk	MWL
Striga S-STR-0 Eminus.blk	MWL
Striga S-STR-0 Infernus.blk	MWL
Striga S-STR-0 Invictus.blk	MWL
Striga S-STR-0 Luminos.blk	MWL
Strike Falcon Attack VTOL.blk	MM
Striker Light Tank (3053 Upgrade).blk	MM
Striker Light Tank (3061 Upgrade).blk	MM
Striker Light Tank (Ammo).blk	MM
Striker Light Tank (Laser).blk	MM
Striker Light Tank (LRM).blk	MM
Striker Light Tank (MML).blk	MWL
Striker Light Tank (Narc).blk	MM
Striker Light Tank (Sealed).blk	MM
Striker Light Tank (SRM).blk	MM
Striker Light Tank Wet.blk	MM
Striker Light Tank.blk	MM
Striker Mk II.blk	MWL
Striker STC-2C.mtf	MM
Striker STC-2D.mtf	MM
Striker STC-2S.mtf	MM
Striker STC-2VC.mtf	MWL
Striker STC-3W.mtf	MWL
Stuka STU-D6.blk	MWL
Stuka STU-D7.blk	MWL
Stuka STU-K10.blk	MWL
Stuka STU-K15.blk	MWL
Stuka STU-K5.blk	MWL
Stuka STU-K5b.blk	MWL
Sturmfeur Heavy Tank (Heavy Gauss).blk	MM
Sturmfeur Heavy Tank (SRM).blk	MM
SturmFeur Heavy Tank (Upgrade).blk	MWL
Sturmfeur Heavy Tank (WoB).blk	MM
Sturmfeur Heavy Tank.blk	MM
SturmFeur Kalki Cruise Missile Launcher.blk	MM
Stygian Strike Tank (Armor).blk	MM
Stygian Strike Tank (WOB).blk	MM
Stygian Strike Tank.blk	MM
Sulla A.blk	MWL
Sulla B.blk	MWL
Sulla C.blk	MWL
Sulla D.blk	MWL
Sulla F.blk	MWL
Sulla G.blk	MWL
Sulla Prime.blk	MWL
Sun Cobra .mtf	MM
Sun Cobra 2.mtf	MM
Sunder SD1-O Samual.mtf	MM
Sunder SD1-O.mtf	MM
Sunder SD1-OA.mtf	MM
Sunder SD1-OB.mtf	MM
Sunder SD1-OC.mtf	MM
Sunder SD1-OD.mtf	MM
Sunder SD1-OE.mtf	MM
Sunder SD1-OF.mtf	MM
Sunder SD1-OG.mtf	MM
Sunder SD1-OK.mtf	MWL
Sunder SD1-OR.mtf	MM
Sunder SD1-OW.mtf	MWL
Sunder SD1-OX.mtf	MM
Super Griffin GRF-2N-X.mtf	MM
Super Wasp WSP-2A-X.mtf	MM
Supernova .mtf	MM
Supernova 2.mtf	MM
Supernova 3.mtf	MM
Supernova 4.mtf	MM
Svantovit Infantry Fighting Vehicle (ATM) Masada.blk	MWL
Svantovit Infantry Fighting Vehicle (ATM).blk	MM
Svantovit Infantry Fighting Vehicle (Original).blk	MM
Svantovit Infantry Fighting Vehicle (SSRM).blk	MWL
Svantovit Infantry Fighting Vehicle.blk	MM
Swallow Attack WIGE (Original).blk	MM
Swallow Attack WIGE (Standard).blk	MM
Swift C.blk	MWL
Swift SW-606.blk	MWL
Swift Wind Scout Car (ICE - Cargo).blk	MM
Swift Wind Scout Car (ICE - Speed).blk	MM
Swift Wind Scout Car (ICE).blk	MM
Swift Wind Scout Car.blk	MM
SYD-45X Starling.blk	MWL
Sylph (Upgrade) Elite.blk	MWL
Sylph Battle Armor (Upgrade).blk	MM
Sylph Battle Armor Enhanced.blk	MM
Sylph Battle Armor.blk	MM
Sylph Elite.blk	MWL
Sylph XR.blk	MM
Tai-Sho TSH-7KC.mtf	MWL
Tai-sho TSH-7S.mtf	MM
Tai-sho TSH-8S.mtf	MM
Tai-Sho TSH-8S2.mtf	MWL
Tai-Sho TSH-9X.mtf	MWL
Talon TLN-5K.mtf	MWL
Talon TLN-5V.mtf	MM
Talon TLN-5W.mtf	MM
Talon TLN-5Z.mtf	MM
Talon TLN-6W.mtf	MM
Talos TLS-1B.mtf	MM
Tamerlane Strike Sled (Flamer).blk	MM
Tamerlane Strike Sled (RL).blk	MM
Tamerlane Strike Sled 2.blk	MM
Tamerlane Strike Sled.blk	MM
Taranis Battle Armor.blk	MM
Tarantula ZPH-1A.mtf	MM
Tarantula ZPH-2A.mtf	MM
Tarantula ZPH-3A.mtf	MM
Tarantula ZPH-4A.mtf	MM
Tarantula ZPH-5A.mtf	MM
Targe TRG-1N.mtf	MM
Targe TRG-2N.mtf	MM
Targe TRG-3M.mtf	MM
Tatsu MIK-O.blk	MWL
Tatsu MIK-OA.blk	MWL
Tatsu MIK-OB.blk	MWL
Tatsu MIK-OC.blk	MWL
Tempest TMP-3G.mtf	MM
Tempest TMP-3M.mtf	MM
Tempest TMP-3M2_Storm_Tempest.mtf	MM
Tempest TMP-3M4.mtf	MWL
Tempest TMP-3MA.mtf	MM
Tempest TMP-TPL2 Home Guard.mtf	MWL
Templar  TLR1-OE.mtf	MWL
Templar III TLR2-O.mtf	MM
Templar III TLR2-OA.mtf	MM
Templar III TLR2-OB.mtf	MM
Templar III TLR2-OC.mtf	MM
Templar III TLR2-OD.mtf	MM
Templar TLR1-BB.mtf	MWL
Templar TLR1-O (Grayson).mtf	MM
Templar TLR1-O (Tancred).mtf	MM
Templar TLR1-O.mtf	MM
Templar TLR1-OA.mtf	MM
Templar TLR1-OB.mtf	MM
Templar TLR1-OC.mtf	MM
Templar TLR1-OD.mtf	MM
Templar TLR1-OE.mtf	MM
Templar TLR1-OF.mtf	MM
Templar TLR1-OG.mtf	MM
Templar TLR1-OH.mtf	MM
Templar TLR1-OI.mtf	MM
Templar TLR1-OR.mtf	MM
Templar TLR1-OU.mtf	MM
Templar TLR1-OV.mtf	MWL
Templar TLR1-SB.mtf	MWL
Tengu (Support).blk	MWL
Tengu Heavy Battle Armor (C3i).blk	MM
Tengu Heavy Battle Armor (ML).blk	MM
Tengu Heavy Battle Armor (RL).blk	MM
Tengu Heavy Battle Armor (Support).blk	MM
Tengu Heavy Battle Armor (VSP).blk	MM
Tengu Heavy Battle Armor.blk	MM
Tengu.blk	MWL
Tenshi TN-10-O.mtf	MM
Tenshi TN-10-OA.mtf	MM
Tenshi TN-10-OB.mtf	MM
Tenshi TN-10-OR.mtf	MM
Tessen TSN-1C.mtf	MM
Tessen TSN-1Cr.mtf	MM
Tessen TSN-C3.mtf	MM
Tessen TSN-C3A.mtf	MWL
Tessen TSN-C3M.mtf	MM
Tessen TSN-X-4.mtf	MM
Testudo Siege Tank Tank.blk	MM
Thanatos THS-4S (Felix).mtf	MM
Thanatos THS-4S.mtf	MM
Thanatos THS-4T.mtf	MM
Thanatos THS-5D.mtf	MWL
Thanatos THS-5S.mtf	MWL
Thanatos THS-6S.mtf	MM
Thanatos TNS-4T.mtf	MWL
Thanatos TNS-6S.mtf	MWL
Thang-Ta APC (Standard).blk	MM
Theseus Medium Battle Armor (RL).blk	MM
Theseus Medium Battle Armor (Support) Killshot.blk	MM
Theseus Medium Battle Armor.blk	MM
Thor (Summoner) A.mtf	MM
Thor (Summoner) AA.mtf	MM
Thor (Summoner) B.mtf	MM
Thor (Summoner) C.mtf	MM
Thor (Summoner) D.mtf	MM
Thor (Summoner) E.mtf	MM
Thor (Summoner) F.mtf	MM
Thor (Summoner) G.mtf	MM
Thor (Summoner) H.mtf	MM
Thor (Summoner) HH.mtf	MM
Thor (Summoner) M.mtf	MM
Thor (Summoner) Prime.mtf	MM
Thor (Summoner) Q.mtf	MM
Thor (Summoner) U.mtf	MM
Thor (Summoner) V.mtf	MWL
Thor (Summoner) Z.mtf	MM
Thor Artillery Vehicle (AC).blk	MM
Thor Artillery Vehicle (C3i).blk	MM
Thor Artillery Vehicle (Clan).blk	MM
Thor Artillery Vehicle.blk	MM
Thor Mk II (Grand Summoner) (Prime).mtf	MM
Thor Mk II (Grand Summoner) A.mtf	MM
Thor Mk II (Grand Summoner) B.mtf	MM
Thor Mk II (Grand Summoner) C.mtf	MM
Thor Mk II (Grand Summoner) D.mtf	MM
Thorn IIC.mtf	MWL
Thorn THE-F.mtf	MM
Thorn THE-N.mtf	MM
Thorn THE-N1.mtf	MM
Thorn THE-N2.mtf	MM
Thorn THE-Nb.mtf	MM
Thorn THE-S.mtf	MM
Thorn THE-T.mtf	MM
Thresher .mtf	MM
Thresher 2.mtf	MM
Thresher 4.mtf	MWL
Thresher Edward.mtf	MM
Thrush TR-7.blk	MWL
Thrush TR-7p.blk	MWL
Thrush TR-8.blk	MWL
Thug  THG-12P.mtf	MWL
Thug  THG-12V.mtf	MWL
Thug IIC.mtf	MWL
Thug THG-10E.mtf	MM
Thug THG-11E (Reich).mtf	MM
Thug THG-11E.mtf	MM
Thug THG-11Eb.mtf	MM
Thug THG-11ECX (Jose).mtf	MM
Thug THG-12D.mtf	MWL
Thug THG-12E.mtf	MM
Thug THG-12K.mtf	MM
Thug THG-12KA.mtf	MWL
Thug THG-12T.mtf	MWL
Thug THG-12WS.mtf	MWL
Thug THG-12Z.mtf	MWL
Thug THG-13K.mtf	MM
Thug THG-13M.mtf	MWL
Thug THG-14K.mtf	MWL
Thug THG-14M.mtf	MWL
Thug THG-14X.mtf	MWL
Thumper Artillery Vehicle Angel.blk	MM
Thumper Artillery Vehicle Maxwell.blk	MM
Thumper Artillery Vehicle TAV-1.blk	MM
Thumper Artillery Vehicle TAV-2.blk	MM
Thumper Artillery Vehicle.blk	MM
Thunder Fox TFT-A9.mtf	MM
Thunder Fox TFT-C3.mtf	MM
Thunder Fox TFT-F11.mtf	MM
Thunder Fox TFT-L8.mtf	MM
Thunder Hawk TDK-7KMA.mtf	MM
Thunder Hawk TDK-7M.mtf	MWL
Thunder Hawk TDK-7S.mtf	MM
Thunder Hawk TDK-7SS.mtf	MWL
Thunder Hawk TDK-7X.mtf	MM
Thunder Hawk TDK-7Y.mtf	MM
Thunder Hawk TDK-9F.mtf	MWL
Thunder Stallion .mtf	MM
Thunder Stallion 2.mtf	MM
Thunder Stallion 3.mtf	MM
Thunder Stallion 4.mtf	MWL
Thunder THR-1L.mtf	MM
Thunder THR-2L.mtf	MM
Thunder THR-2LV.mtf	MWL
Thunder THR-3L.mtf	MM
Thunder THR-4X.mtf	MWL
Thunder THR-C4.mtf	MM
Thunderbird Battle Armor [AP Gauss].blk	MM
Thunderbird Battle Armor [ER Laser].blk	MM
Thunderbird Battle Armor [Pulse Laser].blk	MM
Thunderbird Battle Armor [Upgrade ER Laser].blk	MM
Thunderbird Battle Armor [Upgrade LBX].blk	MM
Thunderbird Battle Armor [Upgrade Pulse Laser].blk	MM
Thunderbird TRB-D36.blk	MWL
Thunderbird TRB-D36b.blk	MWL
Thunderbird TRB-D46.blk	MWL
Thunderbird TRB-D50.blk	MWL
Thunderbird TRB-D56.blk	MWL
Thunderbolt  TDR-CJF.mtf	MWL
Thunderbolt C.mtf	MM
Thunderbolt IIC.mtf	MM
Thunderbolt TDR-10M Ilyena.mtf	MM
Thunderbolt TDR-10M Salazar.mtf	MM
Thunderbolt TDR-10M.mtf	MM
Thunderbolt TDR-10S.mtf	MM
Thunderbolt TDR-10SE.mtf	MM
Thunderbolt TDR-11SE.mtf	MM
Thunderbolt TDR-17S.mtf	MM
Thunderbolt TDR-1C.mtf	MM
Thunderbolt TDR-20Sa.mtf	MWL
Thunderbolt TDR-5S.mtf	MM
Thunderbolt TDR-5Sb.mtf	MM
Thunderbolt TDR-5Sd.mtf	MM
Thunderbolt TDR-5SE.mtf	MM
Thunderbolt TDR-5SS.mtf	MM
Thunderbolt TDR-5S-T Tallman.mtf	MM
Thunderbolt TDR-5T.mtf	MWL
Thunderbolt TDR-60-RLA.mtf	MM
Thunderbolt TDR-7M.mtf	MM
Thunderbolt TDR-7SE.mtf	MM
Thunderbolt TDR-9M.mtf	MM
Thunderbolt TDR-9MS.mtf	MWL
Thunderbolt TDR-9NAIS.mtf	MM
Thunderbolt TDR-9Nr.mtf	MM
Thunderbolt TDR-9RK.mtf	MWL
Thunderbolt TDR-9S.mtf	MM
Thunderbolt TDR-9SE.mtf	MM
Thunderbolt TDR-9T.mtf	MM
Ti Ts'ang DDC TSG9-DDC.mtf	MM
Ti Ts'ang DDC.mtf	MM
Ti Ts'ang TSG-10L.mtf	MM
Ti Tsang TSG-9 China Doll.mtf	MM
Ti Ts'ang TSG-9C.mtf	MM
Ti Tsang TSG-9C.mtf	MWL
Ti Ts'ang TSG-9H.mtf	MM
Ti Ts'ang TSG-9J.mtf	MM
Ti Tsang TSG-9L.mtf	MWL
Tian-Zong TNZ-N1.mtf	MM
Tian-Zong TNZ-N2.mtf	MM
Tian-Zong TNZ-N3.mtf	MM
Tiburon (Standard).mtf	MM
Tiger Medium Tank T-12.blk	MM
Titan II TI-2P.mtf	MM
Titan II TI-2PA.mtf	MM
Titan TI-1A.mtf	MM
Titan TI-1Aj.mtf	MM
Titan TI-1Ar.mtf	MM
Tokugawa Heavy Tank (C3).blk	MM
Tokugawa Heavy Tank (Laser reflective).blk	MWL
Tokugawa Heavy Tank (MRM).blk	MM
Tokugawa Heavy Tank (Streak).blk	MM
Tokugawa Heavy Tank SD2.blk	MM
Tokugawa Heavy Tank TKG-150.blk	MM
Tokugawa Heavy Tank TKG-151.blk	MM
Tokugawa Heavy Tank Yumi.blk	MM
Tokugawa Heavy Tank.blk	MM
Tomahawk (Militia).blk	MWL
Tomahawk (Prime).mtf	MM
Tomahawk A.mtf	MM
Tomahawk B.mtf	MM
Tomahawk C.blk	MWL
Tomahawk C.mtf	MM
Tomahawk CH.blk	MWL
Tomahawk II (Prime).mtf	MM
Tomahawk II A.mtf	MM
Tomahawk II B.mtf	MM
Tomahawk II C.mtf	MM
Tomahawk II MBT.blk	MWL
Tomahawk MBT (Cell II).blk	MWL
Tomahawk MBT (Cell LPPC).blk	MWL
Tomahawk MBT (Cell).blk	MWL
Tomahawk MBT (Upgrade).blk	MWL
Tomahawk MBT.blk	MWL
Tomahawk THK-33.blk	MWL
Tomahawk THK-43.blk	MWL
Tomahawk THK-53.blk	MWL
Tomahawk THK-63.blk	MWL
Tomahawk THK-63b.blk	MWL
Tomahawk THK-63CS.blk	MWL
Tomahawk.blk	MWL
Tonbo Superheavy Transport.blk	MM
Tonbo VTOL .blk	MWL
Tornado PA(L) G12.blk	MM
Tornado PA(L) G13 [David Light Gauss].blk	MM
Tornado PA(L) G13 [Flamer].blk	MM
Tornado PA(L) G13 [Grenade Launcher].blk	MM
Tornado PA(L) G13 [Machine Gun].blk	MM
Tornado PA(L) G13 [Small Laser].blk	MM
Tornado PA(L) G14.blk	MM
Tornado PA(L) G17.blk	MM
Tornado PA(L) P12.blk	MM
Toro TR-A-1.mtf	MM
Toro TR-A-4.mtf	MWL
Toro TR-A-5.mtf	MWL
Toro TR-A-6.mtf	MM
Toro TR-B-2.mtf	MWL
Toyama TYM-1A.mtf	MM
Toyama TYM-1B.mtf	MM
Toyama TYM-1C.mtf	MM
Toyama TYM-1D.mtf	MWL
Toyama TYM-3U.mtf	MWL
Trajan Assault Infantry Fighting Vehicle (ICE).blk	MM
Trajan Assault Infantry Fighting Vehicle (WoB).blk	MWL
Trajan Assault Infantry Fighting Vehicle.blk	MM
Transgressor TR-13.blk	MWL
Transgressor TR-13A.blk	MWL
Transgressor TR-14 AC.blk	MWL
Transgressor TR-14.blk	MWL
Transgressor TR-15.blk	MWL
Transgressor TR-16.blk	MWL
Transit TR-10.blk	MWL
Transit TR-11.blk	MWL
Transit TR-12.blk	MWL
Transportable Field Repair Unit JI-100.blk	MM
Transportable Field Repair Unit Nifty.blk	MM
Trebaruna TR-XB.mtf	MM
Trebaruna TR-XH.mtf	MM
Trebaruna TR-XJ.mtf	MM
Trebaruna TR-XL.mtf	MM
Trebuchet TBT-3C.mtf	MM
Trebuchet TBT-5J.mtf	MM
Trebuchet TBT-5N.mtf	MM
Trebuchet TBT-5S.mtf	MM
Trebuchet TBT-6S.mtf	MWL
Trebuchet TBT-7C.mtf	MWL
Trebuchet TBT-7K.mtf	MM
Trebuchet TBT-7M.mtf	MM
Trebuchet TBT-8B.mtf	MM
Trebuchet TBT-8K.mtf	MWL
Trebuchet TBT-8KL.mtf	MWL
Trebuchet TBT-9CM.mtf	MWL
Trebuchet TBT-9K.mtf	MM
Trebuchet TBT-9L.mtf	MWL
Trebuchet TBT-9M.mtf	MWL
Trebuchet TBT-9R.mtf	MM
Trebuchet TBT-K7R.mtf	MM
Trebuchet TBT-XK7.mtf	MM
Tribune Mobile Tactical Command HQ (Standard).blk	MM
Trident TRN-3T.blk	MWL
Trident TRN-3Tb.blk	MWL
Trireme Infantry Transport (CS).blk	MM
Trireme Infantry Transport.blk	MM
Troika CMT-3T.blk	MWL
Troika CMT-4U.blk	MWL
Tsunami TS-P1.mtf	MM
Tsunami TS-P1D.mtf	MM
Tufana Hovercraft (iNarc).blk	MM
Tufana Hovercraft.blk	MM
Tundra Wolf 2.mtf	MM
Tundra Wolf 3.mtf	MM
Tundra Wolf 4.mtf	MM
Tundra Wolf 4P.mtf	MWL
Tundra Wolf 5.mtf	MM
Tundra Wolf 6.mtf	MWL
Tundra Wolf.mtf	MM
Tunnel Rat Mining Exoskeleton I.blk	MM
Tunnel Rat Mining Exoskeleton II.blk	MM
Tunnel Rat Mining Exoskeleton III.blk	MM
Turhan C3.blk	MWL
Turhan Urban Combat Vehicle (C3).blk	MM
Turhan Urban Combat Vehicle (Standard Armor).blk	MM
Turhan Urban Combat Vehicle (Standard FF 2583).blk	MM
Turhan Urban Combat Vehicle.blk	MWL
Turhan.blk	MWL
Turk A.blk	MWL
Turk B.blk	MWL
Turk C.blk	MWL
Turk D.blk	MWL
Turk G.blk	MWL
Turk Prime.blk	MWL
Turkina A.mtf	MM
Turkina B.mtf	MM
Turkina C.mtf	MM
Turkina D.mtf	MM
Turkina E.mtf	MM
Turkina H.mtf	MM
Turkina J.mtf	MWL
Turkina Prime.mtf	MM
Turkina U.mtf	MM
Turkina X.mtf	MM
Turkina Z.mtf	MM
Typhoon TFN-2A.blk	MWL
Typhoon Urban Assault Vehicle (LB-X).blk	MM
Typhoon Urban Assault Vehicle (LBX).blk	MWL
Typhoon Urban Assault Vehicle (RAC).blk	MM
Typhoon Urban Assault Vehicle (Tracked).blk	MM
Typhoon Urban Assault Vehicle.blk	MM
Typhoon-A TFN-2A.blk	MWL
Typhoon-A TFN-3A.blk	MWL
Typhoon-H TFN-5H.blk	MWL
Typhoon-M TFN-3M.blk	MWL
Tyr Infantry Support Tank (Dominion).blk	MWL
Tyr Infantry Support Tank (Fire Support).blk	MWL
Tyr Infantry Support Tank (Kurita).blk	MM
Tyr Infantry Support Tank.blk	MM
Tyre 2.blk	MWL
Tyre 5.blk	MWL
Tyre.blk	MWL
Uller (Kit Fox)  A.mtf            MWL
Uller (Kit Fox)  C.mtf  	MWL
Uller (Kit Fox) A.mtf	MM
Uller (Kit Fox) B.mtf  	MWL
Uller (Kit Fox) B.mtf	MM
Uller (Kit Fox) C.mtf	MM
Uller (Kit Fox) D.mtf  	MWL
Uller (Kit Fox) D.mtf	MM
Uller (Kit Fox) E.mtf  	MWL
Uller (Kit Fox) E.mtf	MM
Uller (Kit Fox) F.mtf  	            MWL
Uller (Kit Fox) F.mtf	MM
Uller (Kit Fox) G.mtf  	MWL
Uller (Kit Fox) G.mtf	MM
Uller (Kit Fox) H.mtf  	MWL
Uller (Kit Fox) H.mtf	MM
Uller (Kit Fox) I.mtf	MM
Uller (Kit Fox) M.mtf 	MWL
Uller (Kit Fox) Prime.mtf 	MWL
Uller (Kit Fox) Prime.mtf	MM
Uller (Kit Fox) R.mtf	MM
Uller (Kit Fox) S.mtf    	MWL
Uller (Kit Fox) S.mtf	MM
Uller (Kit Fox) U.mtf	MM
Uller (Kit Fox) W.mtf 	MWL
Uller (Kit Fox) W.mtf	MM
Undine (Upgrade) Elite.blk	MWL
Undine Battle Armor (Upgrade).blk	MM
Undine Battle Armor.blk	MM
Undine Elite.blk	MWL
Uni CargoMech ATAE-70.mtf	MM
Uni MilitiaMech ATAE-70.mtf	MM
Uraeus UAE-7R.mtf	MM
UrbanMech IIC .mtf	MM
UrbanMech IIC 2.mtf	MM
UrbanMech IIC 3.mtf	MWL
UrbanMech UM-AIV.mtf	MM
UrbanMech UM-R60.mtf	MM
UrbanMech UM-R60L.mtf	MM
UrbanMech UM-R63.mtf	MM
UrbanMech UM-R64.mtf	MWL
UrbanMech UM-R64M.mtf	MWL
Urbanmech UM-R68.mtf	MM
Urbanmech UM-R69.mtf	MM
UrbanMech UM-R70.mtf	MM
UrbanMech UM-R80.mtf	MM
Ursa URA-2A.mtf	MM
Ursa URA-2C.mtf	MM
Ursus .mtf	MM
Ursus 2.mtf	MM
Ursus 3.mtf	MM
Ursus II.mtf	MM
Ursus PR.mtf	MM
Uziel UZL-2S Jacob II.mtf	MM
Uziel UZL-2S Jacob.mtf	MM
Uziel UZL-2S.mtf	MM
Uziel UZL-3S.mtf	MM
Uziel UZL-4S.mtf	MWL
Uziel UZL-8S.mtf	MM
Vagabond VGB-ND4.mtf	MWL
Vagabond VGB-ND5.mtf	MWL
Vali Artillery Vehicle.blk	MM
Valiant V4-LNT-J3.mtf	MM
Valiant V4-LNT-K7.mtf	MM
Valiant VAL-NT-JX Hot Knife.mtf	MM
Valiant VLN-3T.mtf	MM
Valkyrie IIC.mtf	MWL
Valkyrie VLK-QA.mtf	MM
Valkyrie VLK-QD.mtf	MM
Valkyrie VLK-QD1.mtf	MM
Valkyrie VLK-QD2.mtf	MM
Valkyrie VLK-QD3.mtf	MM
Valkyrie VLK-QD4.mtf	MM
Valkyrie VLK-QD6.mtf	MWL
Valkyrie VLK-QD7.mtf	MWL
Valkyrie VLK-QD8.mtf	MM
Valkyrie VLK-QDA.mtf	MWL
Valkyrie VLK-QF.mtf	MM
Valkyrie VLK-QS5.mtf	MM
Valkyrie VLK-QT2.mtf	MM
Valkyrie VLK-QW5.mtf	MM
Vampyr ScavengerMech SC-V-1.mtf	MM
Vandal A.blk	MWL
Vandal B.blk	MWL
Vandal C.blk	MWL
Vandal D.blk	MWL
Vandal G.blk	MWL
Vandal LI-O.mtf	MM
Vandal LI-OA.mtf	MM
Vandal LI-OB.mtf	MM
Vandal Prime.blk	MWL
Vanquisher VQR-2A.mtf	MM
Vanquisher VQR-2B.mtf	MM
Vanquisher VQR-2BF.mtf	MWL
Vanquisher VQR-4A.mtf	MWL
Vanquisher VQR-5SB.mtf	MWL
Vanquisher VQR-5V.mtf	MM
Vanquisher VQR-7U.mtf	MM
Vanquisher VQR-7V.mtf	MM
Vapor Eagle 2.mtf	MWL
Vapor Eagle 4.mtf	MWL
Vapor Eagle 5.mtf	MWL
Vector (Attack).blk	MM
Vector EW.blk	MM
Vector Scout.blk	MM
Vector Transport.blk	MM
Vedette Medium Tank (3055).blk	MWL
Vedette Medium Tank (AC2).blk	MM
Vedette Medium Tank (Cell).blk	MM
Vedette Medium Tank (Clan RA).blk	MWL
Vedette Medium Tank (Laser).blk	MWL
Vedette Medium Tank (LB-5).blk	MWL
Vedette Medium Tank (LB-X).blk	MM
Vedette Medium Tank (Liao).blk	MM
Vedette Medium Tank (Light Gauss).blk	MM
Vedette Medium Tank (NETC).blk	MM
Vedette Medium Tank (RAC).blk	MM
Vedette Medium Tank (Ultra).blk	MM
Vedette Medium Tank Doris' Delight.blk	MM
Vedette Medium Tank V7.blk	MM
Vedette Medium Tank V9.blk	MM
Vedette Medium Tank V-G7X.blk	MM
Vedette Medium Tank.blk	MM
Velite Heavy Infantry Carrier.blk	MWL
Vendetta Medium Fighter.blk	MM
Venom SDR-9K.mtf	MM
Venom SDR-9KA.mtf	MM
Venom SDR-9KB.mtf	MM
Venom SDR-9KC.mtf	MM
Venom SDR-9KM.mtf	MWL
Verfolger VR5-R.mtf	MM
Verfolger VR5-RR.mtf	MWL
Verfolger VR6-C.mtf	MM
Verfolger VR6-R.mtf	MWL
Verfolger VR6-T.mtf	MM
Victor C.mtf	MM
Victor Li.mtf	MM
Victor VTR-10D.mtf	MM
Victor VTR-10Da.mtf	MWL
Victor VTR-10Db.mtf	MWL
Victor VTR-10Dc.mtf	MWL
Victor VTR-10DF.mtf	MWL
Victor VTR-10L.mtf	MM
Victor VTR-10L1.mtf	MWL
Victor VTR-10S.mtf	MM
Victor VTR-11D.mtf	MM
Victor VTR-9A.mtf	MM
Victor VTR-9A1.mtf	MM
Victor VTR-9B (Shoji).mtf	MM
Victor VTR-9B.mtf	MM
Victor VTR-9D.mtf	MM
Victor VTR-9K.mtf	MM
Victor VTR-9K2 St. James.mtf	MM
Victor VTR-9Ka.mtf	MM
Victor VTR-9S.mtf	MM
Victor VTR-C.mtf	MM
Victor VTR-Cr.mtf	MM
Victor VTR-KHP.mtf	MWL
Vidar Heavy Defense Tank.blk	MM
Viking IIC (Standard).mtf	MM
Viking VKG-2CS.mtf	MWL
Viking VKG-2F.mtf	MM
Viking VKG-2G.mtf	MM
Viking VKG-2GS.mtf	MWL
Viking VKG-3A.mtf	MM
Viking VKG-3W.mtf	MM
Vindicator Dao.mtf	MM
Vindicator VND-1AA Avenging Angel.mtf	MM
Vindicator VND-1R Vong.mtf	MM
Vindicator VND-1R.mtf	MM
Vindicator VND-1SIC.mtf	MM
Vindicator VND-1X.mtf	MM
Vindicator VND-3L.mtf	MM
Vindicator VND-3Lr.mtf	MM
Vindicator VND-4L.mtf	MM
Vindicator VND-4LH.mtf	MWL
Vindicator VND-5L.mtf	MM
Vindicator VND-6L.mtf	MM
Vindicator VND-6LW.mtf	MWL
Vindicator VND-7L.mtf	MWL
Vindicator VND-7LW.mtf	MWL
Violator VT-U1.mtf	MM
Violator VT-U3.mtf	MM
Viper (Black Python) 2.mtf	MM
Viper (Black Python) 3.mtf	MM
Viper (Black Python) 4.mtf	MM
Viper (Black Python).mtf	MM
Visigoth A.blk	MWL
Visigoth B.blk	MWL
Visigoth C.blk	MWL
Visigoth D.blk	MWL
Visigoth J.blk	MWL
Visigoth K.blk	MWL
Visigoth Prime.blk	MWL
Vixen (Incubus 3).mtf	MWL
Vixen (Incubus 4).mtf	MWL
Vixen (Incubus 5).mtf	MWL
Vixen (Incubus) 2.mtf	MM
Vixen (Incubus) 3.mtf	MM
Vixen (Incubus) 4.mtf	MM
Vixen (Incubus) 5.mtf	MM
Vixen (Incubus).mtf	MM
Void Medium Battle Armor (DCA).blk	MM
Void Medium Battle Armor (Nova Cat).blk	MM
Void Medium Battle Armor Caltrop.blk	MM
Void Medium Battle Armor Minelayer.blk	MM
Void Medium Battle Armor.blk	MM
Volkh VKH-1.mtf	MM
Volkh VKH-7.mtf	MM
Von Luckner Heavy Tank (C3i).blk	MWL
Von Luckner Heavy Tank (LRM).blk	MWL
Von Luckner Heavy Tank (Royal).blk	MM
Von Luckner Heavy Tank (Star League).blk	MM
Von Luckner Heavy Tank VNL-K100.blk	MM
Von Luckner Heavy Tank VNL-K65N.blk	MM
Von Luckner Heavy Tank VNL-K70.blk	MM
Von Luckner Heavy Tank VNL-K75N.blk	MM
Von Rohrs (Hebi) VON 4RH-5.mtf	MM
Von Rohrs (Hebi) VON 4RH-6.mtf	MM
Vulcan II VLC-N2.mtf	MWL
Vulcan II VLC-N3.mtf	MWL
Vulcan VL-2T.mtf	MM
Vulcan VL-5T.mtf	MM
Vulcan VLC-5N.blk	MWL
Vulcan VLC-6N.blk	MWL
Vulcan VT-5M.mtf	MM
Vulcan VT-5S.mtf	MM
Vulcan VT-5S2.mtf	MWL
Vulcan VT-5Sr.mtf	MM
Vulcan VT-6C.mtf	MM
Vulcan VT-6M.mtf	MM
Vulcan VT-6ME.mtf	MWL
Vulcan VT-6X.mtf	MWL
Vulcan VT-7M.mtf	MWL
Vulcan VT-7S.mtf	MWL
Vulpes VLP-1D.mtf	MM
Vulture (Mad Dog) A.mtf	MM
Vulture (Mad Dog) B.mtf	MM
Vulture (Mad Dog) C.mtf	MM
Vulture (Mad Dog) D.mtf	MM
Vulture (Mad Dog) E.mtf	MM
Vulture (Mad Dog) F.mtf	MM
Vulture (Mad Dog) G.mtf	MM
Vulture (Mad Dog) GB.mtf	MWL
Vulture (Mad Dog) H.mtf	MM
Vulture (Mad Dog) Mk III (Prime).mtf	MM
Vulture (Mad Dog) Mk III B.mtf	MM
Vulture (Mad Dog) Mk III C.mtf	MM
Vulture (Mad Dog) Mk III D.mtf	MM
Vulture (Mad Dog) Prime SR.mtf	MWL
Vulture (Mad Dog) Prime.mtf	MM
Vulture (Mad Dog) U.mtf	MM
Vulture (Mad Dog) V.mtf	MWL
Vulture Mk III (Mad Dog Mk III) A.mtf	MM
Vulture Mk IV A.mtf	MM
Vulture Mk IV B.mtf	MM
Vulture Mk IV C.mtf	MM
Vulture Mk IV D.mtf	MM
Vulture Mk IV Prime.mtf	MM
Wakazashi.mtf	MM
Waneta S-WN-2LAM.mtf	MM
War Dog WR-DG-02CS.mtf	MWL
War Dog WR-DG-02FC.mtf	MM
War Dog WR-DG-03CS.mtf	MWL
War Dog WR-DG-03FC.mtf	MM
War Dog WR-DG-04FC.mtf	MWL
Warg Assault Battle Armor (Reactive).blk	MM
Warg Assault Battle Armor Elite.BLK	MWL
Warg Assault Battle Armor.blk	MM
Warg Assault Battle Armor.BLK	MWL
Warhammer C.mtf	MM
Warhammer IIC .mtf	MM
Warhammer IIC 10.mtf	MM
Warhammer IIC 11.mtf	MM
Warhammer IIC 12.mtf	MM
Warhammer IIC 2.mtf	MM
Warhammer IIC 3.mtf	MM
Warhammer IIC 4.mtf	MM
Warhammer IIC 5.mtf	MM
Warhammer IIC 6.mtf	MM
Warhammer IIC 7.mtf	MM
Warhammer IIC 8.mtf	MM
Warhammer IIC 9.mtf	MM
Warhammer IICG.mtf	MWL
Warhammer WHD-10CT.mtf	MM
Warhammer WHM-10T.mtf	MM
Warhammer WHM-11T.mtf	MM
Warhammer WHM-4L.mtf	MM
Warhammer WHM-4LV.mtf	MWL
Warhammer WHM-4T.mtf	MWL
Warhammer WHM-5L.mtf	MM
Warhammer WHM-5LS Short-Hammer.mtf	MWL
Warhammer WHM-6D.mtf	MM
Warhammer WHM-6K.mtf	MM
Warhammer WHM-6L.mtf	MM
Warhammer WHM-6R.mtf	MM
Warhammer WHM-6Rb.mtf	MM
Warhammer WHM-6Rk.mtf	MM
Warhammer WHM-6RT.mtf	MWL
Warhammer WHM-6TDF.mtf	MWL
Warhammer WHM-7A.mtf	MM
Warhammer WHM-7K.mtf	MM
Warhammer WHM-7M.mtf	MM
Warhammer WHM-7S.mtf	MM
Warhammer WHM-7TC.mtf	MWL
Warhammer WHM-8CM.mtf	MWL
Warhammer WHM-8D.mtf	MM
Warhammer WHM-8D2.mtf	MM
Warhammer WHM-8DN.mtf	MWL
Warhammer WHM-8K.mtf	MM
Warhammer WHM-8M.mtf	MM
Warhammer WHM-8W.mtf	MWL
Warhammer WHM-9D.mtf	MM
Warhammer WHM-9M.mtf	MWL
Warhammer WHM-9S.mtf	MM
Warhammer WHM-9TC.mtf	MWL
Warlord BLR-2D.mtf	MM
Warlord BLR-2Dr.mtf	MM
Warlord BLR-2G.mtf	MM
Warlord BLR-2XC.mtf	MM
Warrior Attack Helicopter H-10.blk	MWL
Warrior Attack Helicopter H-8M.blk	MWL
Warrior H-10 Attack Helicopter.blk	MM
Warrior H-7 Attack Helicopter.blk	MM
Warrior H-7A Attack Helicopter.blk	MM
Warrior H-7C Attack Helicopter.blk	MM
Warrior H-8 Attack Helicopter.blk	MM
Warrior H-9 Attack Helicopter.blk	MM
Warrior HX-9 Attack Helicopter.blk	MM
Warrior S-9 Stealth Helicopter.blk	MM
Warwolf (Prime).mtf	MM
Warwolf A.mtf	MM
Warwolf B.mtf	MM
Warwolf C.mtf	MM
Warwolf H.mtf	MM
Wasp LAM Mk I WSP-100.mtf	MM
Wasp LAM Mk I WSP-100A.mtf	MM
Wasp LAM Mk I WSP-100b.mtf	MM
Wasp LAM WSP-105.mtf	MM
Wasp LAM WSP-105M.mtf	MM
Wasp LAM WSP-110.mtf	MM
Wasp WSP-1.mtf	MM
Wasp WSP-1A.mtf	MM
Wasp WSP-1D.mtf	MM
Wasp WSP-1K.mtf	MM
Wasp WSP-1L.mtf	MM
Wasp WSP-1S.mtf	MM
Wasp WSP-1W.mtf	MM
Wasp WSP-2D.mtf	MWL
Wasp WSP-3A.mtf	MM
Wasp WSP-3K.mtf	MM
Wasp WSP-3L.mtf	MM
Wasp WSP-3M.mtf	MM
Wasp WSP-3P.mtf	MM
Wasp WSP-3S.mtf	MM
Wasp WSP-3W.mtf	MM
Wasp WSP-4L.mtf	MWL
Wasp WSP-4S.mtf	MWL
Wasp WSP-4X.mtf	MWL
Wasp WSP-5A.mtf	MWL
Wasp WSP-5K.mtf	MWL
Wasp WSP-5L.mtf	MWL
Wasp WSP-7MAF.mtf	MM
Wasp WSP-8T.mtf	MM
Wasp WSP-RA.mtf	MWL
Watchman WTC-4DM.mtf	MM
Watchman WTC-4M.mtf	MM
Watchman WTC-5DM.mtf	MWL
Wayland Mobile Base.blk	MM
Weapon Carrier, Tracked (AC20).blk	MM
Weapon Carrier, Tracked (LB-10X).blk	MM
Weapon Carrier, Tracked (Ultra5).blk	MM
Weapons Carrier A (LL).blk	MM
Wendigo (Prime).mtf	MM
Wendigo A.mtf	MM
Wendigo B.mtf	MM
Wendigo C.mtf	MM
Wendigo-VP (Prime).mtf	MM
Wendigo-VP A.mtf	MM
Werefox (AAV II).blk	MWL
Werefox (AAV).blk	MWL
Werefox (Charlemagne).blk	MWL
Werefox (DArtagnan HA).blk	MWL
Werefox (DArtagnan).blk	MWL
Werefox (Martel ECM).blk	MWL
Werefox (Martel).blk	MWL
Werefox (Petain Prototype).blk	MWL
Werefox (Petain).blk	MWL
Werewolf (C3M).blk	MWL
Werewolf (C3S).blk	MWL
Werewolf WER-LF-004.mtf	MM
Werewolf WER-LF-005.mtf	MM
Wheeled Scout.blk	MM
White Flame WHF-3B.mtf	MM
White Flame WHF-3C.mtf	MM
White Flame WHF-4C.mtf	MM
White Flame WHF-5B.mtf	MWL
White Flame WHF-6W.mtf	MWL
White Flame WHF-6W2 Hunter.mtf	MWL
White Knight WH7-KNT (Star League).mtf	MWL
White Knight WNT-3K.mtf	MWL
White Knight WNT-3KM.mtf	MWL
White Knight WNT-4K.mtf	MWL
White Knight WNT-4KX.mtf	MWL
White Tip Submarine.blk	MM
Whitworth WTH-0.mtf	MM
Whitworth WTH-1.mtf	MM
Whitworth WTH-1H.mtf	MM
Whitworth WTH-1S.mtf	MM
Whitworth WTH-2.mtf	MM
Whitworth WTH-2A.mtf	MM
Whitworth WTH-3.mtf	MM
Whitworth WTH-3TB.mtf	MWL
Whitworth WTH-5S.mtf	MM
Whitworth WTH-K.mtf	MM
Wight Dezgra WGT-4NC.mtf	MM
Wight WGT-1LAWSC.mtf	MM
Wight WGT-1LAWSC3.mtf	MM
Wight WGT-2LAW.mtf	MM
Wight WGT-2LAWC3.mtf	MM
Wight WGT-2SC.mtf	MM
Wight WGT-3SC.mtf	MM
Wildfire P1-WF.mtf	MM
Winston Combat Vehicle (LAC).blk	MM
Winston Combat Vehicle (Support).blk	MM
Winston Combat Vehicle (TSEMP).blk	MM
Winston Combat Vehicle (XXL).blk	MM
Winston Combat Vehicle.blk	MM
Winterhawk APC (Standard).blk	MM
Wirbelwind Flakpanzer (Standard).blk	MWL
Wolf Trap (Tora) WFT-1.mtf	MM
Wolf Trap (Tora) WFT-2.mtf	MM
Wolf Trap (Tora) WFT-2B.mtf	MM
Wolf Trap (Tora) WFT-2X 'Bear Trap'.mtf	MM
Wolf Trap (Tora) WFT-B.mtf	MM
Wolf Trap (Tora) WFT-C.mtf	MM
Wolf Trap Daitama.mtf	MM
Wolf Trap WFT-4.mtf	MWL
Wolf Trap WFT-R1.mtf	MWL
Wolfhound  IIC.mtf	MM
Wolfhound WLF-1 (Allard).mtf	MM
Wolfhound WLF-1.mtf	MM
Wolfhound WLF-1A.mtf	MM
Wolfhound WLF-1B.mtf	MM
Wolfhound WLF-2.mtf	MM
Wolfhound WLF-2H.mtf	MM
Wolfhound WLF-2X.mtf	MM
Wolfhound WLF-3M.mtf	MM
Wolfhound WLF-3S.mtf	MM
Wolfhound WLF-4W.mtf	MM
Wolfhound WLF-4WA.mtf	MM
Wolfhound WLF-5.mtf	MM
Wolfhound WLF-5DS.mtf	MWL
Wolverine II WVR-7H.mtf	MM
Wolverine WVR-11M.mtf	MWL
Wolverine WVR-6K.mtf	MM
Wolverine WVR-6KLB.mtf	MWL
Wolverine WVR-6M.mtf	MM
Wolverine WVR-6R.mtf	MM
Wolverine WVR-7D.mtf	MM
Wolverine WVR-7De.mtf	MWL
Wolverine WVR-7K.mtf	MM
Wolverine WVR-7M.mtf	MM
Wolverine WVR-8C.mtf	MM
Wolverine WVR-8D.mtf	MM
Wolverine WVR-8K.mtf	MM
Wolverine WVR-9D.mtf	MM
Wolverine WVR-9K.mtf	MM
Wolverine WVR-9M.mtf	MM
Wolverine WVR-9W.mtf	MM
Wolverine WVR-9W2.mtf	MM
Woodsman A.mtf	MM
Woodsman Prime.mtf	MM
Wraith Battle Armor (Anti-Infantry).blk	MM
Wraith Battle Armor (Standard).blk	MM
Wraith TR1.mtf	MM
Wraith TR2.mtf	MM
Wraith TR2-X Alexander.mtf	MM
Wraith TR3.mtf	MM
Wulfen (Prime).mtf	MM
Wulfen A.mtf	MM
Wulfen B.mtf	MM
Wulfen C.mtf	MM
Wulfen D.mtf	MM
Wulfen E.mtf	MM
Wulfen H.mtf	MM
Wusun A.blk	MWL
Wusun B.blk	MWL
Wusun C.blk	MWL
Wusun Prime.blk	MWL
Wyvern IIC .mtf	MM
Wyvern IIC 2.mtf	MM
Wyvern WVE-10N.mtf	MM
Wyvern WVE-5N.mtf	MM
Wyvern WVE-5Nb.mtf	MM
Wyvern WVE-5Nsl.mtf	MM
Wyvern WVE-5UX City.mtf	MM
Wyvern WVE-6N.mtf	MM
Wyvern WVE-8RK.mtf	MWL
Wyvern WVE-9N.mtf	MM
Wyvern WVE-CF2.mtf	MWL
Xanthos XNT-2O.mtf	MM
Xanthos XNT-33O.mtf	MWL
Xanthos XNT-3O.mtf	MM
Xanthos XNT-4O.mtf	MM
Xanthos XNT-4OS.mtf	MWL
Xanthos XNT-5O.mtf	MM
Xanthos XNT-6O.mtf	MM
Xanthos XNT-7O.mtf	MM
Xerxes 2.blk	MWL
Xerxes.blk	MWL
Xiphos Assault Battle Armor A.blk	MM
Xiphos Assault Battle Armor B.blk	MM
Xiphos Assault Battle Armor C.blk	MM
Xuan Wu (ST-10).blk	MWL
Xuan Wu (ST-11).blk	MWL
Xue-diao (Ferret).blk	MWL
Yao Lien YOL-4C.mtf	MM
Yasha VTOL (Interdictor).blk	MM
Yasha VTOL Spectre.blk	MM
Yasha VTOL.blk	MM
Yellow Jacket Gunship (Ammo).blk	MM
Yellow Jacket Gunship (Arrow IV).blk	MM
Yellow Jacket Gunship (Periphery).blk	MWL
Yellow Jacket Gunship (PPC).blk	MM
Yellow Jacket Gunship (RAC).blk	MM
Yellow Jacket Gunship (UAC).blk	MWL
Yellow Jacket Gunship.blk	MM
Yeoman YEO-7Y.mtf	MWL
Yeoman YMN-10-OR.mtf	MM
Yeoman YMN-6A.mtf	MWL
Yeoman YMN-6Y.mtf	MM
Yeoman YMN-6YE.mtf	MWL
Yeoman YMN-8TN.mtf	MWL
Yin Long.blk	MWL
Ying Long Medium Battle Armor BC3 [David].blk	MM
Ying Long Medium Battle Armor.blk	MM
Yinghuochong YHC-3E.mtf	MM
Yinghuochong YHC-3Y.mtf	MM
Ymir BWP-2B.mtf	MM
Ymir BWP-2E.mtf	MM
Ymir BWP-3A.mtf	MM
Ymir BWP-4WB.mtf	MWL
Ymir BWP-X1.mtf	MM
Yu Huang Carson.mtf	MM
Yu Huang Y-H10G.mtf	MM
Yu Huang Y-H10L.mtf	MWL
Yu Huang Y-H11G.mtf	MM
Yu Huang Y-H9G.mtf	MM
Yu Huang Y-H9GB.mtf	MM
Yu Huang Y-H9GC.mtf	MM
Yu Huang Y-H9GF.mtf	MWL
Yurei S-YR-1LAM.mtf	MM
Zahn Heavy Transport (Standard).blk	MM
Zephyr Hovertank (C3i).blk	MM
Zephyr Hovertank (CS-RK).blk	MWL
Zephyr Hovertank (LRM).blk	MM
Zephyr Hovertank (Royal).blk	MM
Zephyr Hovertank (SRM2).blk	MM
Zephyr Hovertank.blk	MM
Zephyr IIC.blk	MWL
Zephyros Infantry Support Vehicle (Dual Turret).blk	MM
Zephyros Infantry Support Vehicle.blk	MM
Zephyrus II (Field Refit).blk	MWL
Zephyrus.blk	MWL
Zero ZRO-114.blk	MWL
Zero ZRO-115.blk	MWL
Zero ZRO-116b.blk	MWL
Zeus (Leonidas).mtf	MM
Zeus X ZEU-9WD Stacy.mtf	MM
Zeus X ZEU-9WD.mtf	MM
Zeus X ZEU-X.mtf	MM
Zeus X ZEU-X2.mtf	MM
Zeus X ZEU-X3.mtf	MM
Zeus X ZEU-X4.mtf	MM
Zeus ZEU-10TZ.mtf	MWL
Zeus ZEU-10WB.mtf	MM
Zeus ZEU-11X.mtf	MWL
Zeus ZEU-13S.mtf	MWL
Zeus ZEU-5S.mtf	MM
Zeus ZEU-5T.mtf	MM
Zeus ZEU-6S.mtf	MM
Zeus ZEU-6T.mtf	MM
Zeus ZEU-6Y.mtf	MM
Zeus ZEU-9S.mtf	MM
Zeus ZEU-9S2.mtf	MM
Zeus ZEU-9S-DC.mtf	MM
Zeus ZEU-9T.mtf	MM
Zeus ZEU-X.mtf	MWL
Zeus ZEU-X2.mtf	MWL
Zeus ZEU-X3.mtf	MWL
Zeus-X ZEU-9WD.mtf	MWL
Zhukov Heavy Tank (LB-X).blk	MM
Zhukov Heavy Tank (Liao).blk	MM
Zhukov Heavy Tank (MML).blk	MWL
Zhukov Heavy Tank (Plasma).blk	MWL
Zhukov Heavy Tank (WoB).blk	MM
Zhukov Heavy Tank.blk	MM
Zhukov Mk II.blk	MWL
Zibler Fast Strike Tank (A).blk	MM
Zibler Fast Strike Tank (B).blk	MM
Zibler Fast Strike Tank (C).blk	MM
Zibler Fast Strike Tank (D).blk	MM
Zibler Fast Strike Tank (Prime).blk	MM
Zorya Light Tank (Ammo).blk	MM
Zorya Light Tank (ATM).blk	MM
Zorya Light Tank.blk	MM
Zou Battlearmor C3.blk	MM
Zou Battlearmor.blk	MM
Zugvogel Omni Support Aircraft A.blk	MM
Zugvogel Omni Support Aircraft B.blk	MM
Zugvogel Omni Support Aircraft C.blk	MM
Zugvogel Omni Support Aircraft D.blk	MM
Zugvogel Omni Support Aircraft E.blk	MM
Zugvogel Omni Support Aircraft F.blk	MM
Zugvogel Omni Support Aircraft Prime.blk	MM
